偎	亻田一フノㄟ
眼	目艮
梏	木口
喇	口束刂
除	阝人余下
份	亻八刀
晤	日五口
庥	广亻木
肟	月亏
炟	火日一
鼬	臼フ丶丶フ丶丶フ由
亥	亠フノ人
渴	氵日勹人フ
愣	忄罒方
谀	讠臾
文	亠乂
临	丨丨ノ一丶丨フ丨一
医	匚矢
鄣	立日十阝
曼	日罒又
盼	目八刀
局	尸フ口
伽	亻力口
们	亻门
皤	白ノ米田
蚤	叉虫
荻	艹犭火
捻	扌人丶フ心
镇	钅十具上八
汀	氵丁
籀	扌ノフ丶刀田
巴	巳丨
酣	酉甘
澈	氵亠厶月攵
夏	一自夂
侈	亻夕夕
载	十戈车
郎	丶即左阝
胎	月厶口
藤	艹月氺
痤	疒人人土
吗	口马
嗤	口フ丨丨一虫
严	亚ノ
抻	扌申
纴	纟壬
隳	阝工月人
患	串心
轭	车厂フフ
彭	士口丷一ノノノ
傣	亻寿上ㄟ氺
那	フ一一ノ阝
琇	王禾乃
坼	土斥
靼	革日一
辽	辶了
羽	习习
杼	木フ丨
烟	火囗大
姘	女丷开
受	ノ⺍冖又
毐	士毋
诐	讠フノ丨又
狻	犭厶八夂
苻	艹亻寸
蛳	虫丨ノ一巾
睬	目ノ⺍木
曳	丨フ一一フノ
徭	彳ノ⺍缶
淀	氵宀一丨一人
年	ノ一一丨一丨
菇	艹女十口
抗	扌亠几
忽	勿心
格	木夂口
砼	石人工
追	辶ノ㠯
芗	艹乡
坤	土申
侥	亻一フノ兀
熟	亠口子丸灬
澥	氵用刀牛
蝤	虫丷酉
阳	阝日
忭	忄卞
瘳	疒习习人ノノノ
迭	辶失
鬈	一丨一二厶ノノノフフ
俭	亻人一⺍一
阻	阝且
膏	亠口冖口月
笈	及
埼	土大丁口
孀	女雨木目
扇	户习习
佥	人一⺍一
垤	土一厶土
韬	韦ノ⺍臼
柬	一丨フ丶ノ一丨ノㄟ
片	ノ丨一フ
恣	冫人心
酏	酉也
虻	虫亡
登	フ丶ノノㄟ一口丷一
骐	马其上八
唇	厂二フノㄟ口
囤	囗屯
伥	亻长
袼	衤夂口
题	日一丨一人一ノ冂人
舟	ノノフ丶一丶
碘	石丨フ一丨丨一八
戟	十日十戈
宴	宀日女
疳	疒甘
锇	钅我
骈	马丷开
箴	戌口
窈	宀八幺力
戏	又戈
胗	月人ノノノ
郗	乂巾阝
哇	口土土
以	フ丶人
顼	王一ノ冂人
硼	石月月
裘	求亠𧘇
飘	西二小几乂
棘	一丨フ丨ノㄟ一丨フ丨ノㄟ
绥	纟ノ⺍女
闳	门厶
衬	衤寸
旻	日文
蓇	艹骨
鳀	鱼日一丨一人
塬	土厂白小
减	冫戌口
闻	门耳
礼	礻フ
破	石フノ丨又
俵	亻𧘇
丈	一ノㄟ
率	亠幺冫ノ丶十
掇	扌又又又又
夼	大川
徙	彳止丨一人
柘	木石
言	亠一一口
龙	匕丶
林	木木
茫	艹氵亡
裼	衤日勿
柴	止匕木
养	ㄟノ丨
晏	日宀女
虏	虍力
婀	女阝丁口
枘	木内
忙	忄亡
荇	艹彳亍
蝗	虫白王
这	辶文
翙	山夕习习
列	歹刂
戗	人フフ戈
馐	饣丑
傻	亻ノ囗乂八夂
悻	忄土丷干
炻	火石
霏	雨非
邻	人丶阝
消	氵月
咳	口亠フノ人
劫	土厶力
披	扌フノ丨又
简	门日
钳	钅甘
芫	艹二儿
颤	亠囗口日一一ノ冂人
姐	女且
槐	木鬼
觐	廿丨フ一一一丨一冂见下
祼	礻果
楼	木米女
凇	冫木八厶
桴	木ノ⺍子
蛏	虫又土
雏	彐亻亠
饼	饣丷开
盏	戋皿
哳	口扌斤
桤	木山己
诀	讠夬guài
采	ノ⺍木
苫	艹丨一口
铳	钅亠厶儿
伐	亻戈
娼	女日日
稼	禾宀豕
领	人丶一ノ冂人
袆	衤韦
梆	木寿上阝
椤	木罒夕
贴	冂人丨一口
吻	口勿
别	口力刂
颗	果一ノ冂人
袗	衤人ノノノ
舫	舟方
梗	木更
琳	王木木
佐	亻工
坏	土不
杏	木口
逅	辶ノノ一口
者	耂日
框	木匚王
味	口未
给	纟人一口
扫	扌彐
借	亻艹一日
仙	亻山
肖	月
齐	文ノ丨
悖	忄十冖子
硗	石一フノ兀
葳	艹戌女
栏	木丷三
窀	宀八屯
指	扌匕日
骀	马厶口
骼	骨夂口
伙	亻火
玳	王亻弋
玻	王フノ丨又
趴	八
鼙	士口丷一十又ノ丨フ一一ノ十
莳	艹日寸
朗	丶即左月
蜗	虫口内
埏	土亻一フ廴
柏	木白
勇	用力
拇	扌母
苇	艹韦
髀	骨ノ丨フ一一ノ十
驼	马宀匕
浴	氵八人口
叻	口力
赴	土丨一人卜
朘	156
蜘	虫矢口
马	フフ一
盗	冫人皿
兆	儿冫ノ丶
帐	巾长
丐	一丨一フ
咏	口永
腆	月丨フ一丨丨一八
唣	口白七
艴	弗巴
钏	钅川
谈	讠火火
痘	疒一口丷一
嶙	山米夕一フ丨
疗	疒了
茳	艹氵工
奇	大丁口
掬	扌勹米
屈	尸出
芴	艹勿
驵	马且
即	即左卩
秤	禾平
淙	氵宀二小
八	ノㄟ
徐	彳人余下
标	木二小
堇	廿丨フ一一一丨一
咣	口兀
甏	士口丷一ノノノ瓦
致	一厶土攵
唏	口乂巾
钣	钅ノノ又
骤	马耳又亻ノノノㄟ
锏	钅门日
帙	巾失
悫	士冖几心
炫	火亠幺
肫	月屯
砗	石车
栗	西木
丙	一内
逆	辶丷一フ丨ノ
俐	亻禾刂
忐	上心
瓣	立瓜立十
怆	忄人フフ
耆	耂匕日
舴	舟乍
铣	钅儿
哏	口艮
郫	ノ丨フ一一ノ十阝
诈	讠乍
惫	夂田心
嘘	口虍业
胫	月フ丶工
烫	氵フノノ火
怖	忄巾
矗	十具上十具上十具上
乙	フ
逖	辶犭火
螵	虫西二小
绶	纟ノ⺍冖又
皇	白王
件	亻牛
开	一廾
枵	木口一フ
延	廴亻一フ
岭	山人丶
吣	口心
鲭	鱼月
葬	艹歹匕廾
沭	氵术
浏	氵文刂
欤	与人
笤	刀口
岙	夭山
缶	午凵
彀	士冖一弓几又
伶	亻人丶
杵	木午
咬	口亠八乂
浐	氵产
钬	钅火
汭	氵内
噗	口业ㄟ
钘	钅开
火	丶ノ人
恫	忄冂一口
峙	山土寸
轶	车失
眵	目夕夕
朵	几木
佶	亻士口
召	刀口
备	夂田
庐	广户
惆	忄冂土口
阎	门臼
胆	月日一
洙	氵朱
跏	力口
认	讠人
明	日月
蔗	艹广廿灬
厣	厂犬甲
掣	ノ一一丨フ丨刂手
室	宀一厶土
囵	囗人匕
澶	氵亠囗口日一
听	口斤
搬	扌舟几又
哗	口亻匕十
语	讠五口
愆	彳氵亍心
脆	月厂フフ
甘	廿一
浙	氵扌斤
旎	方ノ一尸匕
帏	巾韦
珣	王勹日
铗	钅夹
口	丨フ一
孤	子瓜
枇	木比左匕
一	一
敬	艹勹口攵
啬	十丷一囗口
娈	亠丨丨ノ丶女
菘	艹木八厶
变	亠丨丨ノ丶又
氤	气囗大
玖	王久
字	宀子
掖	扌亠亻ノフ丶ㄟ
匣	匚甲
挣	扌フ一一丨
尴	尢丨丨ノ一丶皿
犏	牛户冂艹
蔻	艹宀二儿丨一又
芏	艹土
睇	目丷フ一フ丨ノ
疬	疒厂力
均	土勹冫
蝇	虫口电
鹀	工人人鸟
诙	讠火
睫	目一フ一一丨一人
掘	扌尸出
厘	厂里
算	目廾
宗	宀二小
捣	扌ノフ丶フ山
卣	丨一囗フ一
荣	艹冖木
詈	罒亠一一口
说	讠丷口儿
辀	车舟
龀	止人凵匕
匏	大亏勹巳
往	彳主
粤	ノ囗米一フ
谙	讠立日
崭	山车斤
员	口冂人
氙	气山
阗	门十具上八
咻	口亻木
馈	饣中一冂人
钻	钅丨一口
榈	木门口口
劣	少力
症	疒正
激	氵白方攵
萘	艹大二小
峭	山月
甬	用
汤	氵フノノ
屙	尸阝丁口
苣	艹巨
拣	扌一フフノ丶
籴	入米
汴	氵卞
苏	艹办
纭	纟二厶
庭	广壬廴
亭	亠口冖丁
酴	酉人余下
陬	阝耳又
虬	虫フ
拘	扌勹口
兴	⺍一八
掏	扌勹缶
勘	其上八フ力
苘	艹冂口
骙	马フ丶ノノㄟ天
咖	口力口
舣	舟义
汗	氵干
鎏	氵亠厶ノ丨フ金
钇	钅フ
蒇	艹戊冂人
璇	王方ノ一フ丨一人
撇	扌丶ノ丨フ丨ノ丶攵
麽	广木木么
饵	饣耳
蚬	虫冂见下
鹭	夂口鸟
站	立丨一口
折	扌斤
峤	山夭ノ丨
浈	氵丨一冂人
鳤	鱼宀㠯
虫	中一丶
呖	口厂力
扣	扌口
荏	艹亻壬
粗	米且
摇	扌ノ⺍缶
庀	156
蹽	大丶ノ日小
幽	山幺幺
鸭	甲鸟
中	丨フ一丨
蜇	扌斤虫
旬	勹日
席	广廿巾
沈	氵丶フノフ
岈	山牙
涤	氵夂朩
疫	疒几又
化	亻匕
挖	扌宀八フ
猖	犭日日
鲈	鱼丨一尸
萏	艹臼
琏	王车辶
虼	虫乞
纽	纟丑
溽	氵厂二フノㄟ寸
绀	纟甘
蛇	虫宀匕
雇	户亻亠
嘬	口日耳又
孙	子小
描	扌艹田
痫	疒门木
棵	木果
赤	土ノ丨ノ丶
拖	扌ノ一也
勖	冂一一目力
鳈	鱼白水
珏	王玉
菏	艹氵丁口
隼	亻亠十
甫	一丨フ一一丨丶
蔫	艹正一フ灬
浇	氵一フノ兀
渤	氵十冖子力
两	一丨フノ丶ノ丶
酢	酉乍
忾	忄气
俾	亻ノ丨フ一一ノ十
捺	扌大二小
嵇	禾尤山
瞽	士口丷一十又目
圳	土川
区	匚乂
祗	礻氐
碎	石亠人人十
套	大一丨一二厶
铫	钅儿冫ノ丶
跤	亠八乂
熘	火ノフ丶刀田
邢	开阝
肢	月十又
髻	一丨一二厶ノノノ士口
转	车专
皲	冖车フノ丨又
彬	木木ノノノ
卺	了フノㄟ一フフ
馗	九丷一自
硎	石开刂
桎	木一厶土
兖	亠八厶儿
鸤	尸鸟
庤	广土寸
托	扌ノ七
纤	纟千
郢	口王阝
吆	口幺
理	王里
交	亠八乂
朽	木一フ
狺	犭亠一一口
蹾	亠口子攵
盲	亡目
蛲	虫一フノ兀
乾	十日十乞
曲	丨フ一丨丨一
仳	亻比左匕
毗	田比左匕
诗	讠土寸
恍	忄兀
悢	忄良
聍	耳宀丁
遍	辶户冂艹
战	丨一口戈
刘	文刂
揆	扌フ丶ノノㄟ天
谇	讠亠人人十
簇	方ノ一矢
国	囗玉
防	阝方
纾	纟フ丨
平	一丶ノ十
亳	亠口冖ノ七
取	耳又
揖	扌口耳
鏖	广フ丨丨一比左匕金
勺	勹丶
悍	忄日干
傍	亻亠丷冖方
钫	钅方
碣	石日勹人フ
风	几乂
裎	衤口王
伤	亻ノ一力
含	人丶フ口
灼	火勺
奏	寿上ㄟ天
颙	禺一ノ冂人
惘	忄冂丷一亡
烘	火艹一八
陲	阝垂
乳	ノ⺍子フ
抖	扌丶丶十
幻	幺フ
档	木彐
顽	二儿一ノ冂人
酎	酉寸
炼	火一フフノ丶
衽	衤壬
跻	文ノ丨
肘	月寸
绤	纟八人口
煎	丷一月刂灬
跳	儿冫ノ丶
疲	疒フノ丨又
淳	氵亠口子
骇	马亠フノ人
帻	巾冂人
智	矢口日
剖	立口刂
主	丶王
恢	忄火
砣	石宀匕
糇	米亻フ一矢
垣	土一日一
枣	一丨フ丨ノㄟ丶丶
玫	王攵
闺	门土土
戎	戈
足	口丨一人
闲	门木
佾	亻八月
罾	罒丷囗日
栽	十戈木
唆	口厶八夂
巳	フ一フ
焖	火门心
脖	月十冖子
添	氵天
矣	厶矢
叫	口フ丨
佤	亻瓦
焘	寿上寸灬
燎	火大丶ノ日小
鄘	广フ一一丨フ一一丨阝
脘	月宀二儿
甲	丨フ一一丨
锲	钅丰刀大
值	亻十具上
怼	又寸心
矽	156
哆	口夕夕
逼	辶一口田
嗲	口八乂夕夕
胖	月半
旺	日王
鞣	革フ丨ノ木
僖	亻士口丷一口
圣	又土
兼	丷一フ一一丨丨ノㄟ
蜣	虫羌
罗	罒夕
筇	工阝
彗	丰丰彐
荪	艹子小
洳	氵女口
佗	亻宀匕
莆	艹甫
魇	厂犬鬼
煺	火艮辶
乏	ノ之
嚎	口亠口冖豕
皎	白亠八乂
腺	月白水
鹏	月月鸟
柙	木甲
匪	匚非
蝣	虫方ノ一子
冼	冫儿
耘	耒二厶
殇	歹ノ一フノノ
宇	宀于
饽	饣十冖子
侗	亻冂一口
荆	艹开刂
序	广フ丨
亏	二フ
邺	业阝
肺	月一丨フ丨
虎	虍几
胼	月丷开
嚣	口口一ノ冂人口口
分	八刀
戆	立日十夂工冂人心
蚣	虫八厶
聘	耳由一フ
遘	辶一一丨丨一冉
爆	火日艹一八氺
觇	丨一口冂见下
惺	忄日生
烺	火良
胺	月宀女
霎	雨立女
滏	氵八乂干丷一
经	纟フ丶工
泳	氵永
姗	女册
或	戈口一
倘	亻冂口
航	舟亠几
豳	山豕豕
米	丶ノ木
訇	勹亠一一口
类	米大
携	扌亻亠乃
式	弋工
伏	亻犬
雎	且亻亠
蛎	虫厂万
逄	辶夂一フ丨
漏	氵尸雨
哲	扌斤口
俚	亻里
堙	土西土
怄	忄匚乂
袖	衤由
颖	匕禾一ノ冂人
隙	阝小日小
谳	讠十冂丷干犬
葺	艹口耳
尻	尸九
摺	156
瞎	目宀丰口
吲	口弓丨
爪	ノノ丨ㄟ
住	亻主
扼	扌厂フフ
会	人二厶
静	月フ一一丨
耕	耒井
硖	石夹
诳	讠犭王
癣	疒鱼羊
掺	扌厶大ノノノ
寻	彐寸
读	讠十フ丶丶大
玺	小玉
耍	而女
瀍	氵广里八土
驽	女又马
逍	辶月
扪	扌门
罚	罒讠刂
佚	亻失
押	扌甲
凼	水凵
讳	讠韦
樽	木丷酉寸
臼	ノ丨一フ一一
绗	纟彳亍
茆	艹ノフノ卩
疣	疒尤
仗	亻丈
玲	王人丶
栎	木乐
秫	禾术
俏	亻月
姽	女厂フフ
槽	木一丨フ一丨丨一日
秽	禾山夕
弗	フ一フノ丨
拆	扌斥
鋆	土勹冫金
謇	宀一一丨丨一八亠一一口
众	人人人
挺	扌壬廴
嗣	口冂艹フ一口
殳	几又
妫	女为
滚	氵亠八厶𧘇
绚	纟勹日
娴	女门木
屏	尸丷开
璎	王冂人冂人女
蒎	艹氵ノノノフノㄟ
钎	钅千
酪	酉夂口
疙	疒乞
褫	衤ノノ虍几
疖	疒卩
料	米丶丶十
鬼	ノ丨フ一一ノフ厶
责	冂人
镢	钅厂丷一フ丨ノ人
覆	西彳ノ一日夂
郅	一厶土阝
笼	龙
洣	氵米
跎	宀匕
疍	フ丨一人日一
孳	丷一幺幺子
挲	氵少手
敖	フノ攵
啖	口火火
沏	氵七刀
鲏	鱼フノ丨又
邪	牙阝
士	十一
肪	月方
泣	氵立
峣	山一フノ兀
钢	钅冂乂
渎	氵十フ丶丶大
与	一フ一
笳	力口
栖	木西
砖	石专
宬	宀成
阙	门丷一フ丨ノ人
锎	钅门开
昙	日二厶
俗	亻八人口
胪	月丨一尸
沣	氵丰
瓢	西二小瓜
岣	山勹口
阍	门氏日
铢	钅朱
济	氵文ノ丨
嵎	山禺
赎	冂人十フ丶丶大
炕	火亠几
狳	犭人余下
拳	手
孬	不女子
穴	宀八
擎	艹勹口攵手
哎	口艹乂
铙	钅一フノ兀
衫	衤ノノノ
铎	钅又一一丨
怪	忄又土
屣	尸彳止丨一人
傅	亻甫寸
琢	王一ノフノノ丶ノㄟ
炅	日火
嗍	口丷一フ丨ノ月
涎	氵亻一フ廴
痍	疒夷
尬	尢人ノ丨
戳	习习亻亠戈
舳	舟由
暖	日ノ⺍一又
皖	白宀二儿
蒙	艹冖二ノフノノノㄟ
钙	钅丐
恪	忄夂口
舻	舟丨一尸
刻	亠フノ人刂
朴	木卜
仵	亻午
呢	口尸匕
瑢	王宀八人口
哙	口人二厶
隆	阝夂一生
皆	比左匕白
蹇	宀一一丨丨一八口丨一人
嚆	口艹亠口冂口
尼	尸匕
扳	扌ノノ又
艳	丰巴
癖	疒尸口立十
晖	日冖车
店	广丨一口
留	ノフ丶刀田
沚	氵止
蛴	虫文ノ丨
直	十具上
更	一丨フ一一ノㄟ
玢	王八刀
探	扌冖八木
厢	厂木目
篼	白ノフフ一儿
诼	讠一ノフノノ丶ノㄟ
咙	口龙
陆	阝击
躇	艹耂日
溇	氵米女
庇	广比左匕
导	巳寸
岬	山甲
泗	氵囗儿
膳	月羊丷一口
鲬	鱼用
泚	氵止匕
轵	车口八
螫	土ノ丨ノ丶攵虫
错	钅艹一日
糗	米自犬
讣	讠卜
宣	宀一日一
殣	歹廿丨フ一一一丨一
沼	氵刀口
充	亠厶儿
煅	火ノ丨一一一几又
岚	山几乂
鲼	鱼十艹冂人
粼	米夕一フ丨フフ
凳	フ丶ノノㄟ一口丷一几
洗	氵儿
至	一厶土
迤	辶ノ一也
猪	犭耂日
蝴	虫十口月
靴	革亻匕
侵	亻彐冖又
季	禾子
击	一一丨凵
内	丨フノ丶
醅	酉立口
垫	扌丸土
鱼	田一
籼	米山
芎	艹弓
銎	工凡金
贬	冂人乏
鬣	一丨一二厶ノノノフフフ囗乂フ丶丶フ丶丶フ
卢	丨一尸
欣	斤人
鼫	臼フ丶丶フ丶丶フ石
玙	王与
莙	艹尹口
坪	土平
杪	木少
伫	亻宀一
潇	氵艹肃
厕	厂冂人刂
竖	丨丨又立
町	田丁
贼	冂人戈
钺	钅戈フ
扎	扌フ
关	丷天
煳	火十口月
竣	立厶八夂
抢	扌人フフ
绫	纟土八夂
泼	氵フノ又丶
仫	亻么
殚	歹丷丨フ一一一丨
呙	口内
单	丷丨フ一一一丨
捕	扌甫
徇	彳勹日
活	氵千口
龇	止人凵止匕
辇	夫夫车
茎	艹フ丶工
铺	钅甫
挎	扌大亏
猎	犭艹一日
邳	丕阝
阖	门土厶皿
拢	扌龙
窣	宀八亠人人十
纫	纟刃
诚	讠成
雪	雨彐
劢	万力
享	亠口子
吕	口口
阆	门良
峻	山厶八夂
系	ノ幺小
泻	氵冖与
鬏	一丨一二厶ノノノ禾火
苎	艹宀一
笏	勿
拎	扌人丶
嗖	口ノ丨一フ一一丨又
渗	氵厶大ノノノ
戢	口戈丨丨一一一
胳	月夂口
舢	舟山
想	木目心
嵬	山鬼
狙	犭且
拙	扌出
浼	氵丨フ一ノフ
阪	阝ノノ又
岖	山匚乂
万	一フノ
哺	口甫
治	氵厶口
礴	石艹氵甫寸
耻	耳止
头	丶丶大
总	丷口心
璆	王习习人ノノノ
豇	一口丷一工
咆	口勹巳
黾	口电
牢	宀牛
鸬	丨一尸鸟
玎	王丁
莎	艹氵少
魏	禾女鬼
渫	氵世木
筚	比左匕十
丫	丷丨
孚	ノ⺍子
帼	巾囗玉
芙	艹夫
鸫	东鸟
鸼	舟鸟
饴	饣厶口
裴	非亠𧘇
磴	石フ丶ノノㄟ一口丷一
捎	扌月
宏	宀厶
葆	艹亻口木
醢	酉口皿
摆	扌罒土厶
呆	口木
白	ノ日
虽	口虫
漾	氵永
伾	亻丕
恳	艮心
巫	工人人
淫	氵ノ⺍壬
骚	马叉虫
荙	艹大辶
娣	女丷フ一フ丨ノ
逻	辶罒夕
后	ノノ一口
每	ノ一母
纬	纟韦
京	亠口小
躬	身弓
诏	讠刀口
匙	日一丨一人匕
涫	氵宀㠯
痪	疒丨フ大
闪	门人
茕	艹冖フ十
圆	囗口冂人
滇	氵十具上八
织	纟口八
霆	雨壬廴
氏	ノフ一フ
奴	女又
鄢	正一フ灬阝
饫	饣夭
渚	氵耂日
帚	彐冖巾
弇	人一口廾
苕	艹刀口
盆	八刀皿
殖	歹十具上
集	亻亠木
蛆	虫且
氲	气日皿
株	木朱
鳆	156
薅	艹女厂二フノㄟ寸
堪	土其上八フ
槎	木工
再	一冉
镪	钅弓口虫
冕	冂一一丨フ一ノフ
紫	止匕幺小
贫	八刀冂人
写	冖与
洫	氵血
凹	丨フ丨フ一
吱	口十又
故	十口攵
畅	申フノノ
配	酉己
镅	钅フ丨一ノ目
税	禾丷口儿
免	丨フ一ノフ
萱	艹宀一日一
腕	月宀夕フフ
固	囗十口
溻	氵日习习
纻	纟宀一
兕	凹儿
麻	广木木
泫	氵亠幺
咪	口米
牙	一フ丨ノ
呱	口瓜
袪	衤土厶
穆	禾白少ノノ
戍	戊丶
刍	彐
舍	人干口
祎	礻韦
戕	爿戈
任	亻壬
铪	钅人一口
黻	业丶ノ丨フ丨ノ丶又丶
蚺	虫冉
哪	口フ一一ノ阝
沫	氵末
觚	用瓜
疱	疒勹巳
饪	饣壬
骆	马夂口
肩	户月
傩	亻又亻亠
重	ノ一丨フ一一丨一一
喱	口厂里
窖	宀八口
靺	革末
骖	马厶大ノノノ
多	夕夕
婆	氵フノ丨又女
胙	月乍
烙	火夂口
搪	扌广フ一一丨口
痱	疒非
洲	氵州
闱	门韦
贲	十艹冂人
胩	月上卜
烩	火人二厶
惩	彳正心
太	大丶
撅	扌厂丷一フ丨ノ人
密	宀必山
识	讠口八
篆	フフ豕
彻	彳七刀
佻	亻儿冫ノ丶
偌	亻艹口
轻	车フ丶工
眺	目儿冫ノ丶
机	木几
奚	ノ⺍幺大
咕	口十口
谫	讠丷一月刂刀
毖	比左匕必
钕	钅女
诖	讠土土
锱	钅フフフ田
由	丨フ一丨一
将	冫丨夕寸
已	フ一フ
谆	讠亠口子
悌	忄丷フ一フ丨ノ
瀹	氵人一口口口冂艹
塍	月土
肌	月几
瞢	艹罒冖目
枢	木匚乂
垢	土ノノ一口
俣	亻口天
措	扌艹一日
谖	讠ノ⺍一又
诫	讠戈廾
镱	钅立日心
液	氵亠亻ノフ丶ㄟ
锅	钅口内
赆	冂人尺丶丶
浆	冫丨夕水
复	ノ一日夂
忻	忄斤
螺	虫田幺小
祖	礻且
愕	忄口口亏
背	丨一一匕月
矢	ノ天
辣	立束
柢	木氐
险	阝人一⺍一
侣	亻口口
讫	讠乞
鄙	口十囗口阝
鹲	艹冖二ノフノノノㄟ鸟
干	一十
湲	氵ノ⺍一又
桢	木丨一冂人
蚱	虫乍
股	月几又
邡	方阝
擅	扌亠囗口日一
顺	川一ノ冂人
首	丷一自
霪	雨氵ノ⺍壬
轫	车刃
珙	王艹一八
妖	女夭
尚	冂口
斩	车斤
蜢	虫子皿
眢	夕フフ目
佣	亻用
鹪	亻亠灬鸟
莅	艹亻立
菹	艹氵且
囱	ノ囗夂
蛱	虫夹
盱	目于
郡	尹口阝
胡	十口月
串	丨フ一丨フ一丨
枕	木丶フノフ
廖	广习习人ノノノ
鞍	革宀女
迎	辶ノフ卩
翎	人丶习习
面	一ノ囗丨丨一一
垍	土自
俎	人人且
睢	目亻亠
担	扌日一
阱	阝井
怡	忄厶口
嘱	口尸禹
昱	日立
仲	亻中
裢	衤车辶
逡	辶厶八夂
猩	犭日生
编	纟户冂艹
他	亻也
坍	土丹
代	亻弋
棺	木宀㠯
磺	石艹一由八
厅	厂丁
鄹	耳又亻ノノノㄟ阝
绣	纟禾乃
柄	木丙
媪	女日皿
虱	フノ虫
纲	纟冂乂
溲	氵ノ丨一フ一一丨又
噱	口虍豕
亲	立朩
蠕	虫雨而
颢	日亠口小一ノ冂人
袢	衤半
荩	艹尺丶丶
砍	石人
低	亻氐
堍	土丨フ一ノフ丶
兹	丷一幺幺
团	囗才
酹	酉ノ⺍寸
卅	一ノ丨丨
捅	扌用
纣	纟寸
孪	亠丨丨ノ丶子
歪	不正
奢	大耂日
耔	耒子
途	辶人余下
怔	忄正
祢	礻小
芩	艹人丶フ
美	大
而	一ノ冂丨丨
堕	阝月土
倌	亻宀㠯
澎	氵士口丷一ノノノ
点	丨一口灬
杲	日木
缳	纟罒一口𧘇
瘢	疒舟几又
阢	156
饺	饣亠八乂
择	扌又一一丨
凡	几丶
视	礻冂见下
秆	禾干
狩	犭宀寸
投	扌几又
觖	用夬guài
彳	ノ亻
佳	亻土土
夺	大寸
噢	口ノ冂米大
隍	阝白王
轳	车丨一尸
绎	纟又一一丨
院	阝宀二儿
怩	忄尸匕
耩	耒一一丨丨一冉
韪	日一丨一人韦
稆	禾口口
倩	亻月
剕	非刂
跣	儿
疢	疒火
伎	亻十又
船	舟几口
姆	女母
降	阝夂一フ丨
刹	乂朩刂
缎	纟ノ丨一一一几又
瞪	目フ丶ノノㄟ一口丷一
枪	木人フフ
魆	鬼戈フ
茅	艹フ丨ノ
蜕	虫丷口儿
酡	酉宀匕
快	忄夬guài
彖	フフ豕
齉	自田一ノ丨一丨フ一丨冖口口一一丨丨一𧘇
褒	亠亻口木𧘇
痢	疒禾刂
趣	土丨一人耳又
蠼	虫目目亻亠又
既	即左一フノフ
魍	鬼冂丷一亡
囔	口一丨フ一丨冖口口一一丨丨一𧘇
翳	匚矢几又习习
禺	丨フ一一丨フ丨一丶
剅	一口丷一刂
乎	ノ丶ノ一丨
眍	目匚乂
服	月卩又
批	扌比左匕
蜍	虫人余下
抡	扌人匕
攮	扌一丨フ一丨冖口口一一丨丨一𧘇
芡	艹人
硪	石我
纛	母具上小ノ幺小
醭	酉业ㄟ
灞	氵雨革月
鑫	金金金
衢	彳目目亻亠亍
躞	火亠一一口火又
雕	冂土口亻亠
醾	酉广木木米
蠹	一丨フ一丨冖石虫虫
辖	车宀丰口
蠲	丷一八皿罒勹虫
务	夂力
赣	立日十夂工冂人
麟	广フ丨丨一比左匕米夕一フ丨
寤	宀爿五口
锢	钅囗十口
鼷	臼フ丶丶フ丶丶フノ⺍幺大
鼹	臼フ丶丶フ丶丶フ日宀女
浣	氵宀二儿
唢	口冂人
炱	厶口火
甪	ノ用
空	宀八工
唪	口寿上ㄟ一一丨
婺	フ丨ノ攵女
盍	土厶皿
包	勹巳
悱	忄非
狡	犭亠八乂
界	田人ノ丨
敌	千口攵
苡	艹フ丶人
罐	缶艹口口亻亠
糖	米广フ一一丨口
躜	儿儿冂人
鳖	丶ノ丨フ丨ノ丶攵鱼
蒜	艹二小二小
攥	扌目大幺小
攫	扌目目亻亠又
趱	土丨一人儿儿冂人
寺	土寸
鬻	弓米弓一口冂丷一丨
饔	亠乡亻亠人良
瓤	亠口口一一丨丨一𧘇瓜
穰	禾亠口口一一丨丨一𧘇
碰	石丷亚
洞	氵冂一口
髑	骨罒勹虫
躐	フフフ囗乂フ丶丶フ丶丶フ
煸	火户冂艹
瞩	目尸禹
健	亻聿廴
哕	口山夕
圻	土斤
兄	口儿
沤	氵匚乂
禅	礻丷丨フ一一一丨
响	口ノ冂口
馅	饣臼
囊	一丨フ一丨冖口口一一丨丨一𧘇
蘼	艹广木木非
鹳	艹口口亻亠鸟
戡	其上八フ戈
蘸	艹酉亻亠灬
韂	革厂八亠一一口
漆	氵木人氺
蕻	艹一丨一二厶艹一八
耲	156
淹	氵大电
蠡	フフ豕虫虫
羼	尸羊羊
墈	土其上八フ力
禳	礻亠口口一一丨丨一𧘇
倜	亻冂土口
爝	火ノ⺍罒即左寸
夔	丷一自止巳八夂
僦	亻亠口小尤
癫	疒十具上八一ノ冂人
簪	一フノフ一フノフ日
鳡	鱼戌口心
鼱	臼フ丶丶フ丶丶フ月
蒹	艹丷一フ一一丨丨ノㄟ
跹	千辶
疸	疒日一
黯	黑立日
躏	艹门亻亠
泖	氵ノフノ卩
劲	フ丶工力
曩	日亠口口一一丨丨一𧘇
熄	火自心
颦	止丨ノノ一ノ冂人ノ丨フ一一ノ十
镌	钅亻亠乃
旌	方ノ一生
嗌	口丷一八皿
牡	牛土
颔	人丶フ口一ノ冂人
露	雨夂口
磔	石夕一フ丨木
不	一ノ丨丶
礳	156
麒	广フ丨丨一比左匕其上八
瓘	王艹口口亻亠
蠢	寿上ㄟ日虫虫
磋	石工
剡	火火刂
骧	马亠口口一一丨丨一𧘇
譬	尸口立十亠一一口
瀵	氵米田艹一八
灌	氵艹口口亻亠
阅	门丷口儿
蘅	艹彳田大亍
瘅	疒丷丨フ一一一丨
糯	米雨而
魔	广木木鬼
獾	犭艹口口亻亠
鳟	鱼丷酉寸
狲	犭子小
鳞	鱼米夕一フ丨
啕	口勹缶
狸	犭里
阌	门ノ⺍冖又
鳝	鱼羊丷一口
鲨	氵少鱼
臜	月儿儿冂人
鼯	臼フ丶丶フ丶丶フ五口
赍	十冖人人冂人
藕	艹耒禺
浍	氵人二厶
孢	子勹巳
止	丨一丨一
玡	王牙
纂	目大幺小
馓	饣艹一月攵
萩	艹禾火
镴	钅フフフ囗乂フ丶丶フ丶丶フ
镳	钅广フ丨丨一比左匕灬
黥	黑亠口小
黩	黑十フ丶丶大
巉	山口比左匕丨フ一ノフ丶
巍	山禾女鬼
嚷	口亠口口一一丨丨一𧘇
驻	马主
病	疒丙
维	纟亻亠
庆	广大
刺	一丨フ丨ノㄟ刂
嚼	口ノ⺍罒即左寸
了	フ丨
猸	156
歹	一夕
鼍	口口田一口电
茸	艹耳
噜	口鱼日
昕	日斤
躁	口口口木
乖	千丨一一匕
曦	日ノ一丨ノ丶一フフノ丶
矍	目目亻亠又
钍	钅土
耀	兀习习亻亠
欢	又人
酆	山丰丰一口丷一阝
菡	艹了冫ノ丶凵
害	宀丰口
槚	木西冂人
醴	酉曲一口丷一
醵	酉虍豕
联	耳丷天
蘘	艹亠口口一一丨丨一𧘇
蘖	艹ノ㠯立十木
蘩	艹ノ一母攵幺小
廙	广田艹一八
攘	扌亠口口一一丨丨一𧘇
壤	土亠口口一一丨丨一𧘇
牺	牛西
艺	艹フ
蓦	艹日大马
扺	扌氏
瓒	王儿儿冂人
伴	亻半
梅	木ノ一母
忆	忄フ
牲	牛生
色	巴
尹	フ一一ノ
摸	扌艹日大
缵	纟儿儿冂人
葸	艹田心
骥	马丨一一匕田艹一八
疆	弓土一田一田一
棼	木木八刀
谶	讠人人戈韭
猡	犭罒夕
询	讠勹日
匡	匚王
挡	扌彐
桕	木臼
炔	火夬guài
襦	衤雨而
瀛	氵亡口月女凡
瀣	氵丨一夕又韭
瀚	氵十日十人习习
羹	灬大
昝	夂卜日
轴	车由
移	禾夕夕
蠃	亡口月虫凡
醺	酉ノ一丨フ丶ノ一丨一一灬
佴	亻耳
靡	广木木非
忖	忄寸
姻	女囗大
冲	冫中
芸	艹二厶
犸	犭马
衅	血半
蟹	用刀牛虫
觳	士冖一用几又
鳚	鱼尸二小寸
鳙	鱼广フ一一丨フ一一丨
鳗	鱼日罒又
鳕	鱼雨彐
鳔	鱼西二小
鳓	鱼革力
妪	女匚乂
锕	钅阝丁口
物	牛勿
扩	扌广
鼗	儿冫ノ丶士口丷一十又
艨	舟艹冖二ノフノノノㄟ
梽	木士心
齁	自田一ノ丨勹口
鳘	ノ一母攵鱼
簿	氵甫寸
籁	束冂人
簸	其上八フノ丨又
离	亠乂凵丨フフ丶
镲	钅宀ノフ丶丶二小
髌	骨宀丘八
髋	骨宀艹冂见下
黢	黑厶八夂
巅	山十具上八一ノ冂人
妻	一フ一一丨女
榻	木日习习
蠊	虫广丷一フ一一丨丨ノㄟ
蟾	虫厂八亠一一口
蠋	虫罒勹虫
蠓	虫艹冖二ノフノノノㄟ
郄	乂厶阝
胄	由月
司	フ一口
崎	山大丁口
蓍	艹耂匕日
铍	钅フノ丨又
蠖	虫艹亻亠又
蹬	フ丶ノノㄟ一口丷一
铕	钅月
蹿	宀八串
蹭	丷囗日
婪	木木女
蹲	丷酉寸
蹴	亠口小尤
蹯	ノ米田
蝽	虫寿上ㄟ日
森	木木木
蹰	厂一口丷一寸
嚯	口雨亻亠
曝	日日艹一八氺
黼	业丶ノ丨フ丨ノ丶甫
霭	雨讠日勹人フ
慭	来犬心
礤	156
醯	酉亠厶ノ丨フ皿
醮	酉亻亠灬
饻	饣亠𧘇
襻	衤木乂乂木大手
攀	木乂乂木大手
嵖	山木日一
女	フノ一
麓	木木广フ丨丨一比左匕
汹	氵乂凵
屹	山乞
饳	饣出
脲	月尸水
藻	艹氵口口口木
宕	宀石
荔	艹力力力
箕	其上八
蘑	艹广木木石
警	艹勹口攵亠一一口
诎	讠出
迥	辶冂口
蘧	艹虍豕辶
傧	亻宀丘八
鞴	革艹一ノ用
鞲	革一一丨丨一冉
攒	扌儿儿冂人
啸	口肃
洹	氵一日一
畸	田大丁口
垅	156
仆	亻卜
细	纟田
攉	扌雨亻亠
鞅	革央
螅	虫自心
邋	辶フフフ囗乂フ丶丶フ丶丶フ
勍	亠口小力
彝	フフ一米幺小廾
璧	尸口立十玉
襟	衤木木二小
氢	气フ丶工
铡	钅冂人刂
谢	讠身寸
懵	忄艹罒冖目
酲	酉口王
瀌	氵广フ丨丨一比左匕灬
茔	艹冖土
瀑	氵日艹一八氺
邰	厶口阝
冁	丷丨フ一一一丨尸艹一フノㄟ
谡	讠田八夂
獍	犭立日儿
谎	讠艹亡ノ丨フ
奔	大十廾
蝙	虫户冂艹
逮	辶フ一一丨冫ノㄟ
飗	几乂ノフ丶刀田
鹱	鸟艹亻亠又
鳑	鱼亠丷冖方
岱	亻弋山
鳏	鱼罒丨ノノ丶丶
鳎	鱼日习习
鳍	鱼耂匕日
育	亠厶月
缆	纟丨丨ノ一丶冂见下
悲	非心
壳	士冖几
臑	月雨而
翻	ノ米田习习
波	氵フノ丨又
厍	厂车
恼	忄亠乂凵
吡	口比左匕
雠	亻亠讠亻亠
鼩	臼フ丶丶フ丶丶フ勹口
劾	亠フノ人力
鳢	鱼曲一口丷一
尕	乃小
簟	西日十
簠	甫皿
馥	禾日ノ一日夂
萍	艹氵平
菔	艹月卩又
檬	木艹冖二ノフノノノㄟ
氕	气ノ
氮	气火火
镭	钅雨田
镬	钅艹亻亠又
髂	骨宀夂口
油	氵由
琅	王良
汆	入水
驳	马乂乂
黟	黑夕夕
豢	豕
碳	石山火
胲	月亠フノ人
鹮	罒一口𧘇鸟
梳	木亠厶ノ丨フ
嚚	口口臣口口
确	石用
蕺	艹口戈丨丨一一一
捍	扌日干
岢	山丁口
蟪	虫一丨フ一一丨一丶心
蟛	虫士口丷一ノノノ
墼	车凵几又土
鲢	鱼车辶
葡	艹勹甫
孕	乃子
蹢	亠丷冂十口
蹦	山月月
曜	日习习亻亠
珍	王人ノノノ
曛	日ノ一丨フ丶ノ一丨一一灬
燮	火亠一一口火又
筲	月
莱	艹来
瞿	目目亻亠
鲆	鱼平
餮	歹人ノノノ人良
燹	豕豕火
菅	艹宀㠯
甸	勹田
攸	亻丨攵
锸	钅千臼
蔸	艹白ノフフ一儿
礌	石雨田
礓	石一田一田一
埙	土口冂人
蹙	戊上小口丨一人
醪	酉习习人ノノノ
须	ノノノ一ノ冂人
疡	疒フノノ
赢	亡口月冂人凡
檵	156
名	夕口
檫	木宀ノフ丶丶二小
藩	艹氵ノ米田
箭	丷一月刂
斡	十日十人丶丶十
藜	艹禾勹ノ人氺
蚕	天虫
鞧	革丷酉
鞫	革勹亠一一口
叱	口匕
鞭	革亻更
鞨	革日勹人フ
欲	八人口人
鬲	一口冂丷一丨
芍	艹勺
犍	牛聿廴
鞯	革艹丨子
辏	车寿上ㄟ天
葚	艹其上八フ
鳌	フノ攵鱼
蜒	虫亻一フ廴
跆	厶口
鍪	フ丨ノ攵金
鹬	フ丨ノ冂八口鸟
隅	阝禺
癸	フ丶ノノㄟ天
踹	山而
鸹	千口鸟
栳	木耂匕
财	冂人才
索	十冖幺小
蟊	フ丨ノ虫虫
恺	忄山己
龋	止人凵禹
痕	疒艮
嬷	女广木木么
庖	广勹巳
茂	艹戊
陕	阝夹
擘	尸口立十手
臂	尸口立十月
甓	尸口立十瓦
猱	犭フ丨ノ木
檗	尸口立十木
臀	尸艹一八几又月
襁	衤弓口虫
襕	衤门柬
茱	艹朱
牍	片十フ丶丶大
寸	一丨丶
撸	扌鱼日
咸	戌口
豁	宀丰口八人口
石	一ノ口
柳	木ノフノ卩
际	阝二小
蒸	艹了フノㄟ一灬
懦	忄雨而
睐	目来
帆	巾凡
濠	氵亠口冖豕
锡	钅日勿
濞	氵自田一ノ丨
濮	氵亻业ㄟ
矻	石乞
巢	フフフ果
缧	纟田幺小
懑	氵艹两心
淖	氵丨一日十
苔	艹厶口
笕	冂见下
拔	扌又丶
燥	火口口口木
馘	丷一自戈口一
糠	米广フ一一丨冫ノㄟ
危	厂フフ
糟	米一丨フ一丨丨一日
辫	立纟立十
旸	日フノノ
阔	门氵千口
讲	讠井
癌	疒口口口山
癍	疒王文王
膺	广亻亻亠月
縻	广木木幺小
枳	木口八
潆	氵艹冖幺小
糜	广木木米
但	亻日一
闸	门甲
前	丷一月刂
螳	虫冖口土
橛	木厂丷一フ丨ノ人
鹫	亠口小尤鸟
镡	钅西日十
瞻	目厂八亠一一口
螽	夂丶丶虫虫
世	一丨丨一フ
帖	巾丨一口
晕	日冖车
叹	口又
鳊	鱼户冂艹
鳉	鱼冫丨夕寸
咱	口自
汲	氵及
鳇	鱼白王
鳅	鱼禾火
鳄	鱼口口亏
鳃	鱼田心
拍	扌白
狍	犭勹巳
苍	艹人フフ
骎	马亻彐冖又
淆	氵乂月
姬	女匚丨口丨
钱	钅戋
鲾	鱼一口田
坳	土幺力
盅	中皿
耜	耒㠯
杳	木日
靳	革斤
瘸	疒力口内人
辆	车两
雅	牙亻亠
坻	土氐
臃	月亠乡亻亠
臆	月立日心
臁	156
膻	月亠囗口日一
蝻	虫十冂丷干
臊	月口口口木
杻	木丑
葩	艹白巴
臌	月士口丷一十又
貔	豸ノ囗乂比左匕
肥	月巴
貘	豸艹日大
繇	ノ⺍缶ノ幺小
爵	ノ⺍罒即左寸
龠	人一口口口冂艹
腔	月宀八工
滦	氵亠丨丨ノ丶木
徽	彳山一幺小攵
馕	饣一丨フ一丨冖口口一一丨丨一𧘇
鼾	自田一ノ丨干
儡	亻田田田
榕	木宀八人口
兔	丨フ一ノフ丶
蛑	虫厶牛
涅	氵日土
囡	囗女
郓	冖车阝
腌	月大电
煌	火白王
鸢	弋鸟
妍	女开
弼	弓百弓
檀	木亠囗口日一
叟	ノ丨一フ一一丨又
簋	艮皿
天	一大
慨	忄即左一フノフ
啄	口一ノフノノ丶ノㄟ
似	亻フ丶人
簖	米フ斤
簏	广フ丨丨一比左匕
雳	雨厂力
刑	开刂
摭	扌广廿灬
簧	艹一由八
黏	禾人氺丨一口
穗	禾一丨フ一一丨一丶心
飕	几乂ノ丨一フ一一丨又
罅	缶虍乎
泱	氵央
脔	亠丨丨ノ丶内人
壕	土亠口冖豕
棕	木宀二小
镫	钅フ丶ノノㄟ一口丷一
镩	钅宀八串
饯	饣戋
锄	钅且力
泅	氵囗人
甄	西土瓦
稍	禾月
阡	阝千
滢	氵艹冖玉
钰	钅玉
彼	彳フノ丨又
佼	亻亠八乂
矩	矢巨
柩	木匚久
镦	钅亠口子攵
轼	车弋工
脎	月乂朩
潼	氵立里
安	宀女
镣	钅大丶ノ日小
汇	氵匚
黝	黑幺力
飔	几乂田心
掠	扌亠口小
嶷	山匕矢フ丨一人
罽	罒厂火火刂
燔	火ノ米田
羁	罒革马
嚓	口宀ノフ丶丶二小
蟀	虫亠幺冫ノ丶十
荃	艹人王
溯	氵丷一フ丨ノ月
僮	亻立里
螬	虫一丨フ一丨丨一日
蟥	虫艹一由八
里	丨フ一一丨一一
蹐	冫ノ丶人月
腴	月臾
陡	阝土丨一人
凌	冫土八夂
红	纟工
晡	日甫
旰	日干
痰	疒火火
部	立口阝
闰	门王
烨	火亻匕十
胨	月东
墩	土亠口子攵
惨	忄厶大ノノノ
蹊	ノ⺍幺大
蹈	ノ⺍臼
蹋	日习习
蹒	艹两
蹑	耳又又
嚅	口雨而
曙	日罒耂日
嚏	口十冖田フ丨一人
熔	火宀八人口
山	丨凵
饕	口一フ虍几人良
瞵	目米夕一フ丨
鞡	革扌立
瞳	目立里
奕	亠ノ丨ノ丶大
憔	忄亻亠灬
浅	氵戋
潢	氵艹一由八
邓	又阝
瞬	目ノ⺍冖夕一フ丨
瞧	目亻亠灬
肓	亡月
册	ノフノフ一
琰	王火火
瞭	目大丶ノ日小
饩	饣气
涮	氵尸巾刂
慢	忄日罒又
翼	习习田艹一八
霞	雨フ一丨一一フ一又
鲞	鱼
善	羊丷一口
鹩	大丶ノ日小鸟
器	口口犬口口
呔	口太
磷	石米夕一フ丨
粕	米白
鸩	丶フノフ鸟
礅	石亠口子攵
泪	氵目
硌	石夂口
桌	丨一日木
塌	土日习习
繄	匚矢几又幺小
趟	土丨一人冂口
鼢	臼フ丶丶フ丶丶フ八刀
檩	木亠囗口二小
行	彳亍
檐	木厂八亠一一口
鲅	鱼又丶
膊	月甫寸
缢	纟丷一八皿
沅	氵二儿
檑	木雨田
伢	亻牙
瑄	王宀一日一
贱	冂人戋
镰	钅广丷一フ一一丨丨ノㄟ
洱	氵耳
藁	艹亠口冂口木
藓	艹鱼羊
藐	艹豸白儿
缰	纟一田一田一
薷	艹雨而
藏	艹戊フ一ノ臣
鞠	革勹米
薹	艹士口冖一厶土
藉	艹耒艹一日
试	讠弋工
擢	扌习习亻亠
己	フ一フ
楗	木聿廴
砌	石七刀
擦	扌宀ノフ丶丶二小
擤	扌自田一ノ丨
戴	十戈田艹一八
璪	王口口口木
到	一厶土刂
忍	刃心
栌	木丨一尸
豫	フ丨丨フ一ノフノノノㄟ
迢	辶刀口
璨	王丨一夕又米
缴	纟白方攵
缲	纟口口口木
诅	讠且
各	夂口
毅	立ノフノノノ丶几又
疰	疒主
深	氵冖八木
缱	纟中一㠯辶
薰	艹ノ一丨フ丶ノ一丨一一灬
颡	又又又木一ノ冂人
翯	习习亠口冂口
您	亻小心
储	亻讠耂日
旨	匕日
痨	疒艹冖力
鹨	习习人ノノノ鸟
嗨	口氵ノ一母
嬗	女亠囗口日一
隰	阝日幺幺灬
犟	弓口虫牛
门	丶丨フ
嬖	尸口立十女
避	辶尸口立十
壁	尸口立十土
禧	礻士口丷一口
虿	万虫
夕	ノフ丶
惠	一丨フ一一丨一丶心
碡	石母
铄	钅乐
蓄	艹亠幺田
条	夂朩
坡	土フノ丨又
窿	宀八阝夂一生
窸	宀八ノ米心
寰	宀罒一口𧘇
褰	宀一一丨丨一八亠𧘇
黉	⺍冖艹一由八
懈	忄用刀牛
憾	忄戌口心
暌	日フ丶ノノㄟ天
困	囗木
曰	囗一
纱	纟少
蛰	扌丸虫
厦	厂一自夂
乩	丨一口フ
澼	氵尸口立十
咔	口上卜
汕	氵山
蹩	丶ノ丨フ丨ノ丶攵口丨一人
豕	一ノフノノノㄟ
钔	钅门
澹	氵厂八亠一一口
碌	石彐氺
澴	氵罒一口𧘇
澡	氵口口口木
澧	氵曲一口丷一
潞	氵夂口
濉	氵目亻亠
颌	人一口一ノ冂人
濒	氵止丨ノノ一ノ冂人
濑	氵束冂人
燏	火フ丨ノ冂八口
燧	火丷豕辶
居	尸十口
撄	扌冂人冂人女
颛	山而一ノ冂人
燠	火ノ冂米大
锰	钅子皿
甑	丷囗日瓦
田	囗十
瞥	丶ノ丨フ丨ノ丶攵目
磬	士フ丨一ノ几又石
糙	米口辶
羲	ノ一丨ノ丶一フフノ丶
壅	亠乡亻亠土
嬴	亡口月女凡
辩	立讠立十
稚	禾亻亠
凝	冫匕矢フ丨一人
麈	广フ丨丨一比左匕主
麇	广フ丨丨一比左匕禾
斓	文门柬
缙	纟亚日
癃	疒阝夂一生
琎	王井辶
蝌	虫禾丶丶十
植	木十具上
杌	木兀
坌	八刀土
侍	亻土寸
堡	亻口木土
渌	氵彐氺
廪	广亠囗口二小
辜	十口立十
镞	钅方ノ一矢
宅	宀ノ七
荨	艹彐寸
辕	车土口𧘇
瘭	疒西二小
音	立日
赟	文一弋止冂人
鸱	氐鸟
廨	广用刀牛
蕴	艹纟日皿
踱	广廿又
帱	巾寿上寸
晰	日木斤
鹧	广廿灬鸟
李	木子
仍	亻乃
颊	夹一ノ冂人
滍	氵フ丨丨一虫
绍	纟刀口
滂	氵亠丷冖方
黍	禾人氺
迄	辶乞
獬	犭用刀牛
獭	犭束冂人
獴	犭艹冖二ノフノノノㄟ
俄	亻我
俜	亻由一フ
鲻	鱼フフフ田
悠	亻丨攵心
鲹	鱼厶大ノノノ
肠	月フノノ
鲺	鱼フノ虫
膨	月士口丷一ノノノ
绕	纟一フノ兀
猄	犭亠口小
鲸	鱼亠口小
朔	丷一フ丨ノ月
鲷	鱼冂土口
仕	亻士
茄	艹力口
髅	骨米女
鲴	鱼囗十口
鲳	鱼日日
蚰	虫由
鲲	鱼日比左匕
鲱	鱼非
垱	土彐
潲	氵禾月
署	罒耂日
轲	车丁口
聩	耳中一冂人
涟	氵车辶
鲮	鱼土八夂
膙	月弓口虫
拨	扌フノ又丶
几	ノフ
膦	月米夕一フ丨
螣	月虫
膪	156
盦	人丶フ酉皿
歙	人一口习习人
衡	彳田大亍
徼	彳白方攵
邀	辶白方攵
柔	フ丨ノ木
缜	纟十具上八
魈	鬼月
狨	犭戈
魉	鬼两
翱	白大十习习
澉	氵フ耳攵
蜎	虫口月
盥	ノ丨一一水彐皿
埔	土甫
篱	亠乂凵丨フフ丶
篙	亠口冂口
篷	夂丰辶
乱	千口フ
篪	ノノ虍几
篦	ノ囗乂比左匕
氖	气乃
篡	目大厶
篮	丨丨ノ一丶皿
篥	西木
篚	匚非
篝	一一丨丨一冉
侏	亻朱
挨	扌厶矢
孩	子亠フノ人
垌	土冂一口
怠	厶口心
穑	禾十丷一囗口
作	亻乍
憩	千口自心
赞	儿儿冂人
造	辶口
耠	耒人一口
录	彐氺
厄	厂フフ
罕	冖八干
玄	亠幺
氆	毛丷亚日
魅	鬼未
氇	毛鱼日
何	亻丁口
镠	钅习习人ノノノ
瘰	疒田幺小
裙	衤尹口
镜	钅立日儿
朱	ノ未
亍	二丨
粹	米亠人人十
镚	钅山月月
陌	阝百
镘	钅日罒又
俪	亻丽
忪	忄八厶
府	广亻寸
溜	氵ノフ丶刀田
窕	宀八儿冫ノ丶
扔	扌乃
镗	钅冖口土
镖	钅西二小
黔	黑人丶フ
默	黑犬
赠	冂人丷囗日
埴	土十具上
鹚	丷一幺幺鸟
罹	罒忄亻亠
幪	巾艹冖二ノフノノノㄟ
噼	口尸口立十
噻	口宀一一丨丨一八丶丶土
腠	月寿上ㄟ天
恨	忄艮
噫	口立日心
迪	辶由
遨	辶フノ攵
艄	舟月
窅	宀八目
噬	口工人人
骅	马亻匕十
嘌	口西二小
昌	日日
瘌	疒束刂
柱	木主
噪	口口口口木
螟	虫冖日亠八
螠	虫丷一八皿
榴	木ノフ丶刀田
抨	扌平
动	二厶力
螗	虫广フ一一丨口
冠	冖二儿寸
螭	虫亠乂凵丨フフ丶
螈	虫厂白小
舔	千口天
蟆	虫艹日大
蟒	虫艹犬廾
螨	虫艹两
蹂	フ丨ノ木
蹁	户冂艹
蹉	工
络	纟夂口
芨	艹及
黜	黑出
掳	扌虍力
踽	禹
珑	王龙
量	日一里
蹅	木日一
蹀	世木
曈	日立里
觅	ノ⺍冂见下
碱	石戌口
胰	月夷
暾	日亠口子攵
伍	亻五
噤	口木木二小
垩	亚土
东	一フ丨ノ丶
帜	巾口八
嚄	口艹亻亠又
瞰	目フ耳攵
瞠	目冖口土
瞟	目西二小
氅	冂口攵毛
遽	辶虍豕
餐	丨一夕又人良
冀	丨一一匕田艹一八
臻	一厶土寿上ㄟ禾
辚	车米夕一フ丨
辙	车亠厶月攵
胥	フ丨一人月
狄	犭火
拄	扌主
漕	氵一丨フ一丨丨一日
引	弓丨
霍	雨亻亠
狠	犭艮
苠	艹民
苄	艹卞
滘	氵冖八工口
霖	雨木木
殪	歹士冖一口丷一
飙	犬犬犬几乂
乍	ノ一丨一一
赝	厂亻亻亠冂人
磲	石氵巨木
觱	戌口用
蚌	虫丰
婶	女宀申
倨	亻尸十口
侪	亻文ノ丨
湜	氵日一丨一人
婕	女一フ一一丨一人
抔	扌不
醚	酉米辶
呕	口匚乂
醍	酉日一丨一人
州	丶ノ丶丨丶丨
鲪	鱼尹口
菱	艹土八夂
融	一口冂丷一丨虫
橐	一丨フ一丨冖石木
抄	扌少
整	束攵正
鹜	フ丨ノ攵鸟
蹜	宀亻百
橼	木纟フフ豕
橘	木フ丨ノ冂八口
怨	夕フフ心
橙	木フ丶ノノㄟ一口丷一
衩	衤叉
犄	牛大丁口
芄	艹丸
樨	木尸氺牛
橦	木立里
渺	氵目少
橹	木鱼日
为	丶ノフ丶
檎	木人亠乂凵丨フフ丶
樵	木亻亠灬
橇	木毛毛毛
钓	钅勺
襄	亠口口一一丨丨一𧘇
溢	氵丷一八皿
婢	女ノ丨フ一一ノ十
薜	艹尸口立十
涌	氵用
噩	王口口口口
闹	门亠巾
踺	聿廴
痹	疒田一ノ丨
叩	口卩
翰	十日十人习习
涕	氵丷フ一フ丨ノ
颠	十具上八一ノ冂人
薄	艹氵甫寸
菩	艹立口
珩	王彳亍
氪	气十口儿
胱	月兀
薮	艹米女攵
模	木艹日大
蕹	艹亠乡亻亠
逋	辶甫
畔	田半
栲	木耂一フ
镔	钅宀丘八
挹	扌口巴
竺	二
茹	艹女口
薪	艹立朩斤
檠	艹勹口攵木
薇	艹彳山一几攵
加	力口
薛	艹ノ㠯立十
淌	氵冂口
呓	口艹フ
葓	156
腙	月宀二小
锩	钅フフ
蕾	艹雨田
薤	艹歹韭
匹	匚儿
峪	山八人口
法	氵土厶
甩	冂一一フ
埭	土フ一一丨冫ノㄟ
黇	艹一由八丨一口
燕	廿口丨一一匕灬
鞘	革月
糍	米丷一幺幺
蔌	艹束人
抠	扌匚乂
髡	一丨一二厶ノノノ兀
耱	耒广木木石
逛	辶犭王
颞	耳又又一ノ冂人
糕	米灬
擞	扌米女攵
贻	冂人厶口
熹	士口丷一口灬
骺	骨ノノ一口
操	扌口口口木
擂	扌雨田
撼	扌戌口心
擀	扌十日十人干
髹	一丨一二厶ノノノ亻木
莠	艹禾乃
酋	丷酉
腋	月亠亻ノフ丶ㄟ
痄	疒乍
旄	方ノ一毛
帅	丨ノ巾
螯	フノ攵虫
耪	耒亠丷冖方
沪	氵户
璘	王米夕一フ丨
虢	ノ⺍寸虍几
粪	米艹一八
痔	疒土寸
暝	日冖日亠八
帕	巾白
丕	不一
璟	王日亠口小
莪	艹我
聱	フノ攵耳
碲	石亠丷冖巾
审	宀申
揠	扌匚日女
珠	王朱
计	讠十
芹	艹斤
耨	耒厂二フノㄟ寸
抹	扌末
犹	犭尤
删	册刂
禄	礻彐氺
锔	钅尸フ口
馄	饣日比左匕
赌	冂人耂日
骣	马尸子子子
缯	纟丷囗日
哓	口一フノ兀
威	戌女
孺	子雨而
钩	钅勹厶
缬	纟士口一ノ冂人
璩	王虍豕
赪	土ノ丨ノ丶丨一冂人
咩	口羊
冱	冫互
及	ノフㄟ
祲	礻亻彐冖又
椽	木フフ豕
饲	饣フ一口
勰	力力力田心
赜	匚丨口丨冂人
嬉	女士口丷一口
浜	氵丘八
疔	疒丁
颅	丨一尸一ノ冂人
履	尸彳ノ一日夂
劈	尸口立十刀
桄	木兀
苹	艹平
衄	血丑
欺	其上八人
慰	尸二小寸心
熨	尸二小寸火
憨	フ耳攵心
谵	讠厂八亠一一口
鹤	丶フノ丨亠鸟
谴	讠中一㠯辶
禤	礻罒习习
褴	衤丨丨ノ一丶皿
褥	衤厂二フノㄟ寸
娩	女丨フ一ノフ
翩	户冂艹习习
铩	钅乂朩
贪	人丶フ冂人
桔	木士口
洪	氵艹一八
哩	口里
额	宀夂口一ノ冂人
窳	宀八瓜瓜
岍	山开
寮	宀大丶ノ日小
憎	忄丷囗日
憧	忄立里
鲍	鱼勹巳
懊	忄ノ冂米大
预	フ丨一ノ冂人
荠	艹文ノ丨
占	丨一口
次	冫人
翅	十又习习
迅	辶フ十
必	丶フ丶ノ丶
涩	氵刃止
怃	忄无
俅	亻求
考	耂一フ
逃	辶儿冫ノ丶
懂	忄艹重
潏	氵フ丨ノ冂八口
澄	氵フ丶ノノㄟ一口丷一
潺	氵尸子子子
潽	氵丷亚日
澜	氵门柬
潘	氵ノ米田
澳	氵ノ冂米大
迕	辶午
潟	氵臼勹灬
同	冂一口
母	フフ丶一丶
脱	月丷口儿
鄱	ノ米田阝
槲	木用丶丶十
焱	火火火
鋈	氵夭金
鳜	鱼厂丷一フ丨ノ人
潦	氵大丶ノ日小
潭	氵西日十
泜	氵氐
词	讠フ一口
诡	讠厂フフ
玠	王人ノ丨
潸	氵木木月
尜	小大小
没	氵几又
瓠	大亏瓜
谜	讠米辶
铠	钅山己
论	讠人匕
潮	氵十日十月
潵	氵艹一月攵
澌	氵其上八斤
澍	氵士口丷一寸
潜	氵夫夫日
熠	火习习白
橄	木フ耳攵
鹣	丷一フ一一丨丨ノㄟ鸟
妩	女无
共	艹一八
哔	口比左匕十
遵	辶丷酉寸
翦	丷一月刂习习
哌	口ノノノフノㄟ
腱	月聿廴
糅	米フ丨ノ木
糈	米フ丨一人月
铌	钅尸匕
糌	米夂卜日
剜	宀夕フフ刂
糊	米十口月
羰	山火
遛	辶ノフ丶刀田
琼	王亠口小
颜	产ノノノ一ノ冂人
凛	冫亠囗口二小
鹡	冫ノ丶人月鸟
齑	文韭ノ丨
袄	衤夭
瘫	疒又亻亠
莹	艹冖玉
屺	山己
瘠	疒冫ノ丶人月
瘤	疒ノフ丶刀田
瘪	疒自人匕
菪	艹宀石
瘛	疒丰刀心
刨	勹巳刂
鹃	口月鸟
爨	ノ丨一一冂一口フ一一冖木木大火
麾	广木木毛
励	厂万力
抱	扌勹巳
摩	广木木手
花	艹亻匕
馔	饣巳巳艹一八
籍	耒艹一日
鹠	ノフ丶刀田鸟
和	禾口
觯	用丷丨フ一一一丨
獠	犭大丶ノ日小
蒌	艹米女
钌	钅了
獗	犭厂丷一フ丨ノ人
橥	犭耂日木
汜	氵巳
匠	匚斤
氡	气夂丶丶
箜	宀八工
鲫	鱼即左卩
宜	宀且
醛	酉艹人王
胃	田月
烃	火フ丶工
鲩	鱼宀二儿
军	冖车
姹	女宀ノ七
箔	氵白
膛	月冖口土
龅	止人凵勹巳
辅	车甫
鲦	鱼夂朩
鲤	鱼里
拱	扌艹一八
娲	女口内
英	艹央
狱	犭讠犬
陧	阝日土
鲣	鱼丨丨又土
鲡	鱼丽
鲠	鱼更
滕	月氺
早	日十
膘	月西二小
个	人丨
膝	月木人氺
鹟	八厶习习鸟
闩	门一
箍	扌匚巾
峡	山夹
鹞	ノ⺍缶鸟
璠	王ノ米田
泡	氵勹巳
钠	钅内
诜	讠儿
泺	氵乐
鸵	鸟宀匕
蔹	艹人一⺍一攵
绅	纟申
仅	亻又
圄	囗五口
艘	舟ノ丨一フ一一丨又
诔	讠耒
耋	耂匕一厶土
比	比左匕
爱	ノ⺍冖又
舱	舟人フフ
茌	艹亻士
徵	彳山一王攵
怀	忄不
僻	亻尸口立十
锘	钅艹口
蝠	虫一口田
眩	目亠幺
蜩	虫冂土口
儇	亻罒一口𧘇
牖	片户甫
僵	亻一田一田一
仪	亻义
圩	土于
滪	氵フ丨一ノ冂人
篇	户冂艹
藠	艹白白白
偃	亻匚日女
剩	千丨一一匕ノㄟ刂
篌	亻フ一矢
恃	忄土寸
畹	田宀夕フフ
无	一尢
笔	毛
舛	夕一フ丨
创	人フフ刂
戛	一自戈
讼	讠八厶
台	厶口
基	其上八土
珰	王彐
菰	艹子瓜
箱	木目
氍	目目亻亠毛
双	又又
谅	讠亠口小
黎	禾勹ノ人氺
揄	扌人一月刂
稻	禾ノ⺍臼
铘	钅牙阝
纪	纟己
稽	禾尤匕日
革	廿丨フ一一丨
菌	艹囗禾
易	日勿
溪	氵ノ⺍幺大
坩	土甘
筜	彐
污	氵亏
吠	口犬
蔽	艹丶ノ丨フ丨ノ丶攵
肃	フ一一丨ノ丨ノ丶
邃	辶宀八丷豕
悃	忄囗木
象	丨フ一ノフノノノㄟ
镑	钅亠丷冖方
孔	子フ
构	木勹厶
钹	钅又丶
镐	钅亠口冂口
桡	木一フノ兀
镎	钅人一口手
镍	钅自木
厌	厂犬
掌	冖口手
镋	钅冖口儿
镉	钅一口冂丷一丨
处	夂卜
镆	钅艹日大
翚	习习冖车
骸	骨亠フノ人
乐	ノフ丨ノ丶
嶝	山フ丶ノノㄟ一口丷一
罪	罒非
轪	车大
彪	虍几ノノノ
嶓	山ノ米田
穷	宀八力
幞	巾业ㄟ
骜	フノ攵马
燃	火ノフ丶丶犬灬
窜	宀八串
贡	工冂人
噔	口フ丶ノノㄟ一口丷一
洺	氵夕口
噀	口巳巳艹一八
噌	口丷囗日
躅	罒勹虫
噙	口人亠乂凵丨フフ丶
铹	钅艹冖力
附	阝亻寸
噍	口亻亠灬
笱	勹口
惋	忄宀夕フフ
印	ノフ一卩
骍	马立十
嘿	口黑
窍	宀八工一フ
颚	口口亏一ノ冂人
底	广氐
井	一一ノ丨
癔	疒立日心
晔	日亻匕十
陔	阝亠フノ人
虔	虍文
蛩	工凡虫
缪	纟习习人ノノノ
剌	束刂
蝼	虫米女
伪	亻为
蝓	虫人一月刂
螋	虫ノ丨一フ一一丨又
疠	疒万
嘹	口大丶ノ日小
斑	王文王
蝎	虫日勹人フ
蝰	虫大土土
淡	氵火火
巡	辶フフフ
阄	门丨フ一一フ
牛	ノ一一丨
扛	扌工
嫔	女宀丘八
儋	亻厂八亠一一口
淅	氵木斤
现	王冂见下
掰	八刀手
蝾	虫艹冖木
诱	讠禾乃
蝶	虫世木
吩	口八刀
昔	艹一日
戌	戊一
种	禾中
舌	千口
蹼	业ㄟ
祾	礻土八夂
踪	宀二小
幼	幺力
眇	目少
踣	立口
绉	纟彐
踩	ノ⺍木
踬	ノノ十冂人
元	二儿
踟	矢口
踏	水日
踢	日勿
踝	果
馏	饣ノフ丶刀田
影	日亠口小ノノノ
缅	纟面
恋	亠丨丨ノ丶心
亡	亠フ
因	囗大
虹	虫工
纡	纟于
雄	厶亻亠
聋	龙耳
暹	辶日亻亠
拌	扌半
宪	宀儿
苌	艹长
粱	氵刀ノ丶米
蓰	艹彳止丨一人
铰	钅亠八乂
讪	讠山
嘲	口十日十月
噶	口艹日勹人フ
庼	广比左一ノ冂人
嘶	口其上八斤
噎	口士冖一口丷一
嘭	口士口丷一ノノノ
嘻	口士口丷一口
猞	犭人干口
幺	フ厶
方	丶万
赡	冂人厂八亠一一口
斝	口口冖丶丶十
浡	氵十冖子
唠	口艹冖力
瞌	目土厶皿
祆	礻天
的	白勺
肋	月力
鹅	我鸟
龊	止人凵口丨一人
筱	亻丨攵
久	ノフㄟ
疹	疒人ノノノ
暄	日宀一日一
龉	止人凵五口
厩	厂即左一フノフ
杂	九朩
霈	雨氵一丨フ丨
莩	艹ノ⺍子
幕	艹日大巾
汪	氵王
玩	王二儿
痣	疒士心
隔	阝一口冂丷一丨
霄	雨月
综	纟宀二小
震	雨厂二フノㄟ
酃	雨口口口阝
淝	氵月巴
碾	石尸艹一フノㄟ
玛	王马
莛	艹壬廴
役	彳几又
磅	石亠丷冖方
眸	目厶牛
磙	石亠八厶𧘇
霸	雨革月
榔	木丶即左阝
磊	石石石
帡	巾丷开
磕	石土厶皿
餍	厂犬人良
抃	扌卞
鸡	又鸟
渡	氵广廿又
靥	厂犬面
掷	扌丷天阝
沙	氵少
醇	酉亠口子
醌	酉日比左匕
橡	木丨フ一ノフノノノㄟ
鹋	艹田鸟
鹝	一口冂丷一丨鸟
疑	匕矢フ丨一人
憋	丶ノ丨フ丨ノ丶攵心
樟	木立日十
趄	土丨一人且
醋	酉艹一日
碓	石亻亠
琥	王虍几
获	艹犭犬
梓	木立十
樱	木冂人冂人女
庹	广廿尺
委	禾女
樘	木冖口土
蛸	虫月
樗	木雨亏
槭	木戊上小
荛	艹一フノ兀
樯	木十丷一囗口
横	木艹一由八
姜	女
仡	亻乞
绡	纟月
满	氵艹两
槿	木廿丨フ一一一丨一
扃	户冂口
旷	日广
庳	广ノ丨フ一一ノ十
飨	乡人良
闷	门心
磨	广木木石
裨	衤ノ丨フ一一ノ十
规	夫冂见下
畋	田攵
蔬	艹フ止亠厶ノ丨フ
递	辶丷フ一フ丨ノ
婿	女フ丨一人月
蕰	艹氵日皿
怒	女又心
倒	亻一厶土刂
耒	丰ノㄟ
嗷	口フノ攵
蕲	艹丷丨フ一一一丨斤
蕃	艹ノ米田
琛	王冖八木
焓	火人丶フ口
脓	月农
搛	扌丷一フ一一丨丨ノㄟ
娱	女口天
蕉	艹亻亠灬
御	彳午一丨一卩
柠	木宀丁
羡	冫人
蟠	虫ノ米田
愿	厂白小心
儿	ノフ
蕞	艹日耳又
贵	中一冂人
鄯	羊丷一口阝
脯	月甫
焯	火丨一日十
枨	木长
猃	犭人一⺍一
范	艹氵フフ
蕨	艹厂丷一フ丨ノ人
怫	忄弗
喘	口山而
蕙	艹一丨フ一一丨一丶心
洄	氵囗口
陋	阝丙フ
鞋	革土土
俩	亻两
聪	耳丷口心
鲰	鱼耳又
撰	扌巳巳艹一八
举	⺍一八一一丨
撺	扌宀八串
弹	弓丷丨フ一一一丨
增	土丷囗日
撙	扌丷酉寸
凋	冫冂土口
叛	半ノノ又
幡	巾ノ米田
乡	フフノ
撞	扌立里
擒	扌人亠乂凵丨フフ丶
狃	犭丑
拃	扌乍
勃	十冖子力
映	日央
饨	饣屯
捷	扌一フ一一丨一人
墦	土ノ米田
播	扌ノ米田
赭	土ノ丨ノ丶耂日
撬	扌毛毛毛
票	西二小
撮	扌日耳又
撑	扌冖口手
懋	木フ丨ノ木心
撩	扌大丶ノ日小
资	冫人冂人
撒	扌艹一月攵
炒	火少
悒	忄口巴
荷	艹亻丁口
核	木亠フノ人
撕	扌其上八斤
煜	火日立
砸	石匚巾
髫	一丨一二厶ノノノ刀口
髯	一丨一二厶ノノノ冉
靠	口非
奭	大百百
碜	石厶大ノノノ
袜	衤末
坠	阝人土
杠	木工
鸨	匕十鸟
蚯	虫丘
肛	月工
邛	工阝
璋	王立日十
贰	弋二冂人
散	艹一月攵
璀	王山亻亠
璜	王艹一由八
瑾	王廿丨フ一一一丨一
锵	钅冫丨夕寸
缇	纟日一丨一人
慧	丰丰彐心
缫	纟フフフ果
缩	纟宀亻百
骢	马ノ囗夂心
顸	干一ノ冂人
沄	氵二厶
犋	牛具上八
芋	艹于
矸	石干
边	辶力
埸	土日勿
瑛	王艹央
峄	山又一一丨
呛	口人フフ
缨	纟冂人冂人女
骡	马田幺小
濡	氵雨而
盯	目丁
捃	扌尹口
千	ノ十
缦	纟日罒又
缥	纟西二小
信	亻亠一一口
雯	雨文
铷	钅女口
骠	马西二小
瞀	フ丨ノ攵目
熊	厶月匕匕灬
保	亻口木
忝	天
瓷	冫人瓦
烧	火一フノ兀
胧	月龙
郧	口冂人阝
翠	习习亠人人十
泄	氵世
阊	门日日
鼐	乃目フ一ノ丨一丨フ
嫪	女习习人ノノノ
嫡	女亠丷冂十口
嫜	女立日十
嫘	女田幺小
嫚	女日罒又
嫦	女冖口巾
黹	业丶ノ丨フ丨ノ丶
耿	耳火
绹	纟勹缶
吃	口乞
嫖	女西二小
尔	小
嫩	女束攵
嫱	女十丷一囗口
谔	讠口口亏
嫣	女正一フ灬
气	ノ一一フ
隧	阝丷豕辶
鹛	フ丨一ノ目鸟
暨	即左一フノフ日一
谲	讠フ丨ノ冂八口
逯	辶彐氺
谱	讠丷亚日
谰	讠门柬
梨	禾刂木
墨	黑土
禚	礻灬
球	王求
萃	艹亠人人十
褪	衤艮辶
谥	讠丷一八皿
谄	讠臼
射	身寸
褛	衤米女
褓	衤亻口木
褐	衤日勹人フ
褙	衤丨一一匕月
褡	衤艹人一口
谮	讠一フノフ一フノフ日
官	宀㠯
忡	忄中
谭	讠西日十
寥	宀习习人ノノノ
眠	目民
景	日亠口小
癯	疒目目亻亠
烛	火虫
汔	氵乞
郛	ノ⺍子阝
胛	月甲
走	土丨一人
陷	阝臼
晷	日夂卜口
姿	冫人女
察	宀ノフ丶丶二小
窭	宀八米女
锽	钅白王
窬	宀八人一月刂
寡	宀一ノ且八刀
搴	宀一一丨丨一八手
赛	宀一一丨丨一八冂人
崴	山戌女
慵	忄广フ一一丨フ一一丨
勋	口冂人力
苋	艹冂见下
慷	忄广フ一一丨冫ノㄟ
龌	止人凵尸一厶土
潍	氵纟亻亠
羌	フ
侔	亻厶牛
劓	自田一ノ丨刂
抓	扌爪
塾	亠口子丸土
漩	氵方ノ一フ丨一人
夸	大亏
滴	氵亠丷冂十口
漳	氵立日十
漉	氵广フ丨丨一比左匕
漪	氵犭大丁口
宄	宀九
殄	歹人ノノノ
王	一土
蜊	虫禾刂
眊	目毛
朊	156
冯	冫马
羝	氐
杜	木土
坜	土厂力
依	亻亠𧘇
丰	一一一丨
潴	氵犭耂日
潋	氵人一⺍一攵
璃	王亠乂凵丨フフ丶
漶	氵串心
笨	本
羔	灬
辔	纟车纟口
漯	氵田幺小
翌	习习立
漫	氵日罒又
滹	氵虍乎
漂	氵西二小
漱	氵束人
呃	口厂フフ
忌	己心
懿	士冖一口丷一冫人心
漤	氵木木女
柰	木二小
凿	业丷一十凵
辱	厂二フノㄟ寸
熥	火用辶
裸	衤果
煽	火户习习
凯	山己几
渭	氵田月
圜	囗罒一口𧘇
槠	木讠耂日
扯	扌止
歉	丷一フ一一丨丨ノㄟ人
娇	女夭ノ丨
爿	フ丨一ノ
镛	钅广フ一一丨フ一一丨
返	辶ノノ又
畛	田人ノノノ
敛	人一⺍一攵
绝	纟巴
蜜	宀必虫
霜	雨木目
鄞	廿丨フ一一一丨一阝
妲	女日一
旖	方ノ一大丁口
旗	方ノ一其上八
端	立山而
韶	立日刀口
竭	立日勹人フ
绵	纟白巾
瘙	疒叉虫
瘘	疒米女
彤	丹ノノノ
港	氵艹一八巳
瘦	疒ノ丨一フ一一丨又
搋	扌ノノ虍几
笄	开
茓	艹宀八
瘟	疒日皿
瘗	疒夹土
锷	钅口口亏
萋	艹一フ一一丨女
瘩	疒艹人一口
许	讠午
唷	口亠厶月
矜	フ丨ノ人丶フ
男	田力
锃	钅口王
课	讠果
馨	士フ丨一ノ几又禾日
茯	艹亻犬
缔	纟亠丷冖巾
蓁	艹寿上ㄟ禾
嘛	口广木木
演	氵宀一由八
豪	亠口冖豕
敲	亠口冂口丨一又
苓	艹人丶
塥	土一口冂丷一丨
拓	扌石
銮	亠丨丨ノ丶金
喜	士口丷一口
宾	宀丘八
夤	夕宀一由八
奸	女干
楸	木禾火
祸	礻口内
友	又
饸	饣人一口
刖	月刂
雒	夂口亻亠
魄	白鬼
觫	用束
鹰	广亻亻亠鸟
獐	犭立日十
果	丨フ一一一丨ノㄟ
照	日刀口灬
佝	亻勹口
敷	甫方攵
铃	钅人丶
买	フ丶丶大
腧	月人一月刂
申	丨フ一一丨
鲜	鱼羊
鲛	鱼亠八乂
酯	酉匕日
罔	冂丷一亡
鲚	鱼文ノ丨
力	フノ
抛	扌九力
鲙	鱼人二厶
鲔	鱼月
鲑	鱼土土
婉	女宀夕フフ
膀	月亠丷冖方
二	一一
膈	月一口冂丷一丨
地	土也
檄	木白方攵
莓	艹ノ一母
角	用
霰	雨艹一月攵
轱	车十口
炯	火冂口
悯	忄门文
邯	甘阝
肯	止月
窄	宀八乍
蒋	艹冫丨夕寸
骄	马夭ノ丨
艋	舟子皿
睾	ノ罒土丷干
魃	鬼又丶
鼻	自田一ノ丨
僧	亻丷囗日
疃	田立里
麝	广フ丨丨一比左匕身寸
喃	口十冂丷干
癜	疒尸艹一八几又
仔	亻子
僬	亻亻亠灬
僭	亻一フノフ一フノフ日
僚	亻大丶ノ日小
僳	亻西米
儆	亻艹勹口攵
舆	ノ丨一一车フ一一一八
毓	ノ一母亠厶ノ丨フ
郿	フ丨一ノ目阝
裰	衤又又又又
秸	禾士口
箓	彐氺
绌	纟出
箫	肃
声	士フ丨一ノ
棰	木垂
胯	月大亏
郯	火火阝
距	巨
阜	ノ㠯十
箢	宀夕フフ
管	宀㠯
箪	丷丨フ一一一丨
箩	罒夕
箅	田一ノ丨
镃	钅丷一幺幺
箬	艹口
陛	阝比左匕土
侩	亻人二厶
啃	口止月
滔	氵ノ⺍臼
川	ノ丨丨
挛	亠丨丨ノ丶手
猛	犭子皿
昃	日厂人
瘃	疒一ノフノノ丶ノㄟ
愧	忄鬼
阃	门囗木
茛	艹艮
箸	耂日
忱	忄丶フノフ
俱	亻具上八
刿	山夕刂
枰	木平
箧	匚夹
耷	大耳
箦	冂人
箐	月
熏	ノ一丨フ丶ノ一丨一一灬
稳	禾彐心
性	忄生
犒	牛亠口冂口
锋	钅夂丰
舞	ノ一一丨丨丨丨一夕一フ丨
镄	钅弗冂人
訄	九亠一一口
镂	钅米女
鄄	西土阝
该	讠亠フノ人
候	亻丨フ一矢
耧	耒米女
骨	丨フフ冖月
侬	亻农
窨	宀八立日
锻	钅ノ丨一一一几又
锹	钅禾火
嵚	山钅人
招	扌刀口
倻	亻耳阝
苛	艹丁口
封	土土寸
骶	骨氐
灿	火山
聿	フ一一一一丨
驸	马亻寸
弱	弓冫弓冫
鹌	大电鸟
骷	骨十口
偿	亻冖二厶
恿	用心
桨	冫丨夕木
恧	而心
表	𧘇
九	ノフ
赚	冂人丷一フ一一丨丨ノㄟ
穄	禾ノフ丶丶二小
赙	冂人甫寸
铋	钅必
幢	巾立里
嶂	山立日十
幔	巾日罒又
罱	罒十冂丷干
障	阝立日十
痃	疒亠幺
旃	方ノ一丹
蚜	虫牙
罴	罒土厶灬
嘧	口宀必山
灰	火
雾	雨夂力
镨	钅丷亚日
恰	忄人一口
嘚	口彳日一寸
嘤	口冂人冂人女
崩	山月月
殿	尸艹一八几又
垛	土几木
访	讠方
斋	文而
嘣	口山月月
鹗	口口亏鸟
嘡	口冖口土
搒	扌亠丷冖方
螂	虫丶即左阝
畜	亠幺田
控	扌宀八工
豆	一口丷一
吾	五口
鹇	门木鸟
振	扌厂二フノㄟ
蜱	虫ノ丨フ一一ノ十
蜴	虫日勿
蝈	虫囗玉
蜾	虫果
啜	口又又又又
堂	冖口土
蜥	虫木斤
蜡	虫艹一日
裱	衤𧘇
蜞	虫其上八
跄	人フフ
晃	日兀
淄	氵フフフ田
奋	大田
棱	木土八夂
蜻	虫月
掾	扌フフ豕
颍	匕水一ノ冂人
跽	己心
踉	良
睛	目月
诩	讠习习
铒	钅耳
推	扌亻亠
锜	钅大丁口
踌	寿上寸
靛	月宀一丨一人
沓	水日
暧	日ノ⺍冖又
嘎	口一自戈
甜	千口甘
诠	讠人王
嘁	口戊上小
嗽	口束人
岛	ノフ丶フ山
嘞	口革力
墅	里フ丨土
睽	目フ丶ノノㄟ天
瞍	目ノ丨一フ一一丨又
瞅	目禾火
夥	果夕夕
蜃	厂二フノㄟ虫
裳	冖口亠𧘇
纷	纟八刀
龈	止人凵艮
链	钅车辶
贿	冂人月
雌	止匕亻亠
崔	山亻亠
恚	土土心
哨	口月
沩	氵为
翡	非习习
阋	门臼儿
洌	氵歹刂
钒	钅凡
窠	宀八果
锓	钅彐冖又
泓	氵弓厶
茧	艹虫
蜚	非虫
辗	车尸艹一フノㄟ
势	扌丸力
厾	フ土厶
耖	耒少
殡	歹宀丘八
豨	豕乂巾
臧	戊フ一ノ臣
劂	厂丷一フ丨ノ人刂
碥	石户冂艹
帝	亠丷冖巾
丝	フフフフ一
碹	石宀一日一
磁	石丷一幺幺
耰	耒一ノ丨フ一一冖心夂
碴	石木日一
锾	钅ノ⺍一又
锨	钅斤人
甾	フフフ田
碶	石丰刀大
浩	氵口
嵩	山亠口冂口
浔	氵彐寸
用	冂一一丨
厮	厂其上八斤
旋	方ノ一フ丨一人
酸	酉厶八夂
酿	酉良
荧	艹冖火
酶	酉ノ一母
捧	扌寿上ㄟ一一丨
酷	酉口
赔	冂人立口
矛	フ丨ノ
酾	酉丽
非	丨一一一丨一一一
酵	酉耂子
僰	一丨フ丨ノㄟ一丨フ丨ノㄟ人
蒉	艹中一冂人
歌	丁口丁口人
榍	木尸月
卧	臣卜
畎	田犬
榨	木宀八乍
槟	木宀丘八
榜	木亠丷冖方
槁	木亠口冂口
螃	虫亠丷冖方
垃	土立
槔	木白大十
榭	木身寸
咛	口宀丁
槜	木亻亠乃
兰	丷三
皋	白大十
蚋	虫内
找	扌戈
酰	酉儿
艾	艹乂
岌	山及
榫	木亻亠十
塞	宀一一丨丨一八土
貌	豸白儿
鲌	鱼白
葜	艹丰刀大
笠	立
欠	人
呜	口乌
榧	木匚非
芯	艹心
群	尹口羊
钛	钅太
蓼	艹习习人ノノノ
叼	口刁
兢	十口儿十口儿
鹕	十口月鸟
蔚	艹尸二小寸
睃	目厶八夂
熙	匚丨口丨巳灬
匜	匚也
蓿	艹宀亻百
蕖	艹氵巨木
权	木又
钨	钅乌
驿	马又一一丨
哧	口土ノ丨ノ丶
泠	氵人丶
咨	冫人口
话	讠千口
铧	钅亻匕十
穿	宀八牙
泌	氵必
镓	钅宀豕
执	扌丸
蔺	艹门亻亠
蔟	艹方ノ一矢
拯	扌了フノㄟ一
通	辶用
蔡	艹ノフ丶丶二小
姨	女夷
嫫	女艹日大
蔑	艹罒戍
苯	艹本
蔓	艹日罒又
摹	艹日大手
跬	土土
慕	艹日大
靿	革幺力
涛	氵寿上寸
靽	革半
蔷	艹十丷一囗口
聚	耳又亻ノノノㄟ
且	丨フ一一一
唛	口夂
撖	扌フ耳攵
榖	士冖一木几又
看	目
摔	扌亠幺冫ノ丶十
狰	犭フ一一丨
朋	月月
恂	忄勹日
稔	禾人丶フ心
聂	耳又又
遂	辶丷豕
摘	扌亠丷冂十口
铜	钅冂一口
境	土立日儿
焌	火厶八夂
簌	束人
宠	宀龙
贝	冂人
瓜	ノノフ丶ㄟ
誓	扌斤亠一一口
锛	钅大十廾
踅	扌斤口丨一人
翥	耂日习习
截	十戈亻亠
赫	土ノ丨ノ丶土ノ丨ノ丶
摧	扌山亻亠
惕	忄日勿
摞	扌田幺小
撂	扌田夂口
恻	忄冂人刂
墟	土虍业
柃	木人丶
埃	土厶矢
摽	扌西二小
墙	土十丷一囗口
诿	讠禾女
鐾	尸口立十金
蛋	フ丨一人虫
妤	女フ丨
饱	饣勹巳
嫠	未攵厂女
焰	火臼
椭	木阝月
觏	一一丨丨一冉冂见下
熬	フノ攵灬
示	二小
豌	一口丷一宀夕フフ
尿	尸水
副	一口田刂
剧	尸十口刂
汝	氵女
良	丶艮
助	且力
铛	钅彐
瑶	王ノ⺍缶
碧	王白石
来	一丶ノ一丨ノㄟ
耥	耒冂口
剿	フフフ果刂
侄	亻一厶土
径	彳フ丶工
枋	木方
骟	马户习习
辄	车耳フ
龄	止人凵人丶
弩	女又弓
杨	木フノノ
完	宀二儿
艰	又艮
宝	宀玉
扰	扌尤
胂	月申
颃	亠几一ノ冂人
梃	木壬廴
烂	火丷三
缤	纟宀丘八
缣	纟丷一フ一一丨丨ノㄟ
缡	纟亠乂凵丨フフ丶
嗓	口又又又木
淤	氵方人丶丶
脚	月土厶卩
祛	礻土厶
蚓	虫弓丨
骝	马ノフ丶刀田
缝	纟夂丰辶
缛	纟厂二フノㄟ寸
缚	纟甫寸
显	日业
瘾	疒阝彐心
叠	又又又冖且
就	亠口小尤
颁	八刀一ノ冂人
嫌	女丷一フ一一丨丨ノㄟ
巩	工凡
收	フ丨攵
嫒	女ノ⺍冖又
媲	女ノ囗乂比左匕
媳	女自心
薨	艹罒冖歹匕
珧	王儿冫ノ丶
茜	艹西
晓	日一フノ兀
犰	犭九
媾	女一一丨丨一冉
怂	人人心
适	辶千口
淠	氵田一ノ丨
辟	尸口立十
榛	木寿上ㄟ禾
谬	讠习习人ノノノ
谪	讠亠丷冂十口
诌	讠彐
号	口一フ
溱	氵寿上ㄟ禾
福	礻一口田
诰	讠口
禊	礻丰刀大
裾	衤尸十口
褚	衤耂日
评	讠平
褂	衤土土卜
捋	扌ノ⺍寸
涿	氵一ノフノノ丶ノㄟ
栋	木东
缄	纟戌口
枸	木勹口
垸	土宀二儿
谨	讠廿丨フ一一一丨一
寝	宀冫丨彐冖又
聊	耳ノフノ卩
亩	亠田
唧	口即左卩
晗	日人丶フ口
窦	宀八十フ丶丶大
铅	钅几口
锧	钅ノノ十冂人
菜	艹ノ⺍木
寞	宀艹日大
骞	宀一一丨丨一八马
槛	木丨丨ノ一丶皿
鲎	⺍冖鱼
誉	⺍一八亠一一口
慊	忄丷一フ一一丨丨ノㄟ
慥	忄口辶
慎	忄十具上八
揪	扌禾火
愫	忄幺小
滩	氵又亻亠
溺	氵弓冫弓冫
蜓	虫壬廴
霓	雨臼儿
溟	氵冖日亠八
喾	⺍冖口
牌	片ノ丨フ一一ノ十
疾	疒矢
埋	土里
眨	目乏
罄	士フ丨一ノ几又缶
滨	氵宀丘八
佩	亻几一巾
蟋	虫ノ米心
木	十ノㄟ
在	丨土
舰	舟冂见下
爰	ノ⺍一又
橱	木厂一口丷一寸
孝	耂子
邂	辶用刀牛
溏	氵广フ一一丨口
莜	艹亻丨攵
镧	钅门柬
牚	冂口牙
艚	舟一丨フ一丨丨一日
滃	氵八厶习习
溴	氵自犬
滫	氵亻丨夂月
滗	氵毛
溦	氵彳山一几攵
筌	人王
溷	氵囗豕
裟	氵少亠𧘇
滥	氵丨丨ノ一丶皿
滤	氵虍心
源	氵厂白小
溧	氵西木
溥	氵甫寸
漠	氵艹日大
烊	火羊
袋	亻弋亠𧘇
郊	亠八乂阝
思	田心
誊	亠一一口
垓	土亠フノ人
庄	广土
惊	忄亠口小
溘	氵土厶皿
钧	钅勹冫
妃	女己
素	幺小
氩	气亚
咧	口歹刂
谩	讠日罒又
滟	氵丰巴
躔	广里八土
煊	火宀一日一
戚	戊上小
刚	冂乂刂
煨	火田一フノㄟ
撷	扌士口一ノ冂人
煤	火甘木
竟	立日儿
唾	口垂
验	马人一⺍一
钷	钅匚口
塑	丷一フ丨ノ月土
猷	丷酉犬
数	米女攵
孜	子攵
粳	米更
组	纟且
怊	忄刀口
蚨	虫夫
姝	女朱
滠	氵耳又又
绠	纟更
钾	钅甲
黠	黑士口
羧	厶八夂
阘	门日习习
脂	月匕日
祃	礻马
雍	亠乡亻亠
旒	方ノ一亠厶ノ丨フ
掼	扌フフノ一冂人
事	一丨フ一フ一一丨
歆	立日人
新	立朩斤
峰	山夂丰
泰	寿上ㄟ氺
靖	立月
裔	亠𧘇冂八口
麂	广フ丨丨一比左匕几
捡	扌人一⺍一
瘆	疒厶大ノノノ
杓	木勺
沿	氵几口
岿	山丨ノ彐
狷	犭口月
苷	艹甘
瘁	疒亠人人十
瘐	疒臾
酊	酉丁
痿	疒禾女
闾	门口口
腊	月艹一日
晳	156
椋	木亠口小
舄	臼勹灬
痼	疒囗十口
萧	艹肃
叨	口刀
啰	口罒夕
亶	亠囗口日一
让	讠上
禀	亠囗口二小
拜	一丰
帔	巾フノ丨又
鹑	亠口子鸟
酱	冫丨夕酉
踔	丨一日十
馍	饣艹日大
宰	宀立十
馌	饣土厶皿
煞	彐攵灬
解	用刀牛
遒	辶丷酉
记	讠己
屿	山与
触	用虫
娌	女里
恒	忄一日一
觥	用兀
聒	耳千口
蹄	亠丷冖巾
炊	火人
鹐	臼鸟
鹄	口鸟
猿	犭土口𧘇
肄	匕矢聿
棋	木其上八
幄	巾尸一厶土
膂	方ノ一ノフノㄟ月
秃	禾几
吨	口屯
芜	艹无
四	囗儿
乔	夭ノ丨
盛	成皿
萨	艹阝产
鲋	鱼亻寸
蛛	虫朱
稣	鱼禾
硭	石艹亡
鲉	鱼由
鲇	鱼丨一口
詹	厂八亠一一口
呷	口甲
腿	月艮辶
腾	月马
媵	月女
染	氵九木
腹	月ノ一日夂
绩	纟冂人
嗾	口方ノ一矢
腥	月日生
垧	土ノ冂口
郑	丷天阝
腽	月日皿
腼	月面
栒	木勹日
腰	月西女
讷	讠内
砒	石比左匕
腩	月十冂丷干
舂	寿上ㄟ臼
腻	月弋二冂人
建	廴聿
枯	木十口
垯	土大辶
赋	冂人一弋止
霹	雨尸口立十
相	木目
貅	豸亻木
囫	囗勿
绪	纟耂日
脸	月人一⺍一
毹	人一月刂毛
觎	人一月刂冂见下
巷	艹一八巳
筛	丨ノ一巾
挚	扌丸手
孛	十冖子
微	彳山一几攵
衙	彳五口亍
冽	冫歹刂
敫	白方攵
茚	艹ノフ一卩
忠	中心
旧	丨日
飒	立几乂
释	ノ米又一一丨
拂	扌弗
窃	宀八七刀
筷	忄夬guài
莶	艹人一⺍一
魁	鬼丶丶十
鹎	ノ丨フ一一ノ十鸟
躲	身几木
像	亻丨フ一ノフノノノㄟ
坯	土丕
杯	木不
娘	女良
煲	亻口木火
督	上小又目
煦	日勹口灬
舅	臼田力
毁	臼工几又
驺	马彐
筼	口冂人
筻	更
羿	习习廾
殷	ノノ彐フ几又
筢	扌巴
筠	土勹冫
筹	寿上寸
廿	艹一
颓	禾几一ノ冂人
宛	宀夕フフ
殛	歹了口又一
秋	禾火
稠	禾冂土口
庠	广羊
觋	工人人冂见下
纠	纟フ丨
溠	氵工
釜	八乂干丷一
墒	土亠丷冂八口
稗	禾ノ丨フ一一ノ十
辨	立丶ノ立十
椐	木尸十口
节	艹卩
轺	车刀口
歃	千臼人
始	女厶口
辞	千口立十
溅	氵冂人戋
硷	156
愉	忄人一月刂
键	钅聿廴
缸	缶工
锬	钅火火
锫	钅立口
锪	钅勿心
诛	讠朱
玚	王フノノ
锦	钅白巾
圹	土广
锤	钅垂
锣	钅罒夕
毛	ノ一一フ
厚	厂日子
习	フ冫
农	丶フノフノㄟ
扊	户火火
捂	扌五口
膜	月艹日大
茶	艹人朩
杧	木亡
祝	礻口儿
迨	辶厶口
壬	千一
竦	立束
人	ノㄟ
笃	马
削	月刂
鬃	一丨一二厶ノノノ宀二小
躺	身冂口
锗	钅耂日
锖	钅月
锌	钅立十
嵴	山冫ノ丶人月
夯	大力
侨	亻夭ノ丨
嵊	山千丨一一匕ノㄟ
幌	巾日兀
夬	フ一ノㄟ
罩	罒丨一日十
拶	扌フフフ夕
谛	讠亠丷冖巾
腒	月尸十口
酒	氵酉
罨	罒大电
置	罒十具上
蚧	虫人ノ丨
缠	纟广里
挂	扌土土
戊	戈ノ
传	亻专
嗵	口用辶
嗡	口八厶习习
嗳	口ノ⺍冖又
陶	阝勹缶
根	木艮
砹	石艹乂
晶	日日日
刊	干刂
嗥	口白大十
嗅	口自犬
俺	亻大电
徨	彳白王
跷	一フノ兀
纯	纟屯
普	丷亚日
湛	氵其上八フ
虮	虫几
敦	亠口子攵
应	广⺍一
儒	亻雨而
蜈	虫口天
祓	礻又丶
琚	王尸十口
汛	氵フ十
脒	月米
柝	木斥
羞	丑
参	厶大ノノノ
殃	歹央
遣	辶中一㠯
跟	艮
诣	讠匕日
拊	扌亻寸
跪	厂フフ
苊	艹厂フフ
囹	囗人丶
隶	フ一一丨冫ノㄟ
跺	几木
跸	比左匕十
雹	雨勹巳
蛹	虫用
盹	目屯
菂	艹白勺
硫	石亠厶ノ丨フ
跨	大亏
暮	艹日大日
皮	フノ丨又
康	广フ一一丨冫ノㄟ
碛	石冂人
胚	月丕
郚	五口阝
懒	忄束冂人
遢	辶日习习
暇	日フ一丨一一フ一又
妓	女十又
暅	日忄一日一
暗	日立日
歇	日勹人フ人
鼠	臼フ丶丶フ丶丶フ
昧	日未
厂	一ノ
胜	月生
烜	火一日一
把	扌巴
盟	日月皿
侠	亻夹
立	亠丷一
嗄	口一自夂
时	日寸
闶	门亠几
偈	亻日勹人フ
愚	禺心
嗝	口一口冂丷一丨
诃	讠丁口
嗦	口十冖幺小
嗔	口十具上八
嗬	口艹亻丁口
嗫	口耳又又
狯	犭人二厶
嗜	口耂匕日
悚	忄束
嘟	口耂日阝
肚	月土
睥	目ノ丨フ一一ノ十
睨	目臼儿
冒	冂一一目
睡	目垂
殊	歹朱
嗪	口寿上ㄟ禾
醒	酉日生
瞄	目艹田
炜	火韦
簃	禾夕夕
调	讠冂土口
睹	目耂日
笋	尹
项	工一ノ冂人
半	丶ノ一一丨
鉴	丨丨ノ一丶金
昶	永日
虞	虍口天
耸	人人耳
阶	阝人ノ丨
粲	丨一夕又米
婧	女月
埯	土大电
柯	木丁口
觜	止匕用
党	冖口儿
龆	止人凵刀口
龃	止人凵且
腚	月宀一丨一人
酚	酉八刀
帷	巾亻亠
频	止丨ノノ一ノ冂人
牒	片世木
遄	辶山而
粒	米立
毪	毛厶牛
辐	车一口田
郜	口阝
娓	女尸毛
扒	扌八
锚	钅艹田
典	丨フ一丨丨一八
甚	其上八フ
连	辶车
腮	月田心
煮	耂日灬
莲	艹车辶
酮	酉冂一口
肷	月人
碗	石宀夕フフ
准	冫亻亠
镶	钅亠口口一一丨丨一𧘇
嵛	山人一月刂
碚	石立口
屃	尸冂人
啶	口宀一丨一人
碉	石冂土口
鸿	氵工鸟
碍	石日一寸
感	戌口心
讽	讠几乂
酩	酉夕口
剽	西二小刂
赖	束冂人
刮	千口刂
戮	习习人ノノノ戈
庞	广龙
怦	忄平
蒺	艹疒矢
楣	木フ丨一ノ目
戒	戈廾
划	戈刂
蓂	艹冖日亠八
铂	钅白
沃	氵夭
饧	饣フノノ
祯	礻丨一冂人
宋	宀木
残	歹戋
珊	王册
菊	艹勹米
鏊	フノ攵金
楦	木宀一日一
泯	氵民
絷	扌丸幺小
起	土丨一人己
榇	木立朩
海	氵ノ一母
榆	木人一月刂
蒡	艹亠丷冖方
槌	木ノ㠯辶
椴	木ノ丨一一一几又
椟	木十フ丶丶大
广	亠ノ
楫	木口耳
榄	木丨丨ノ一丶冂见下
骓	马亻亠
楷	木比左匕白
狒	犭弗
苒	艹冉
诹	讠耳又
枝	木十又
掸	扌丷丨フ一一一丨
俞	人一月刂
郦	丽阝
蒂	艹亠丷冖巾
鬯	乂丶丶丶丶凵匕
泃	氵勹口
楝	木柬
楚	木木フ丨一人
胸	月勹乂凵
疚	疒久
楂	木木日一
诋	讠氐
禁	木木二小
楠	木十冂丷干
咂	口匚巾
肼	月井
贷	亻弋冂人
瓶	丷开瓦
楔	木丰刀大
蓣	艹フ丨一ノ冂人
贤	丨丨又冂人
颐	匚丨口丨一ノ冂人
蓥	艹冖金
蓉	艹宀八人口
蒗	艹氵良
蒲	艹氵甫
出	フ丨丨凵
髓	骨工月辶
芒	艹亡
楯	木ノノ十目
抒	扌フ丨
祧	礻儿冫ノ丶
蒟	艹立勹口
坝	土冂人
她	女也
飧	夕人良
蓠	艹亠乂凵丨フフ丶
楹	木乃又皿
崃	山来
虚	虍业
帛	白巾
告	口
锶	钅田心
丛	人人一
谋	讠甘木
蓑	艹亠丨フ一一𧘇
蓬	艹夂丰辶
泷	氵龙
蓟	艹鱼刂
销	钅月
摄	扌耳又又
蓖	艹ノ囗乂比左匕
蓓	艹亻立口
卒	亠人人十
晋	亚日
獒	フノ攵犬
荒	艹亡ノ丨フ
鬓	一丨一二厶ノノノ宀丘八
墓	艹日大土
然	ノフ丶丶犬灬
丹	ノフ丶一
婊	女𧘇
狮	犭丨ノ一巾
佞	亻二女
烦	火一ノ冂人
栝	木千口
娜	女フ一一ノ阝
锂	钅里
勤	廿丨フ一一一丨一力
阚	门フ耳攵
浃	氵夹
颧	艹口口亻亠一ノ冂人
屋	尸一厶土
绞	纟亠八乂
弟	丷フ一フ丨ノ
梯	木丷フ一フ丨ノ
遮	辶广廿灬
袯	衤フノ又丶
搡	扌又又又木
摊	扌又亻亠
祭	ノフ丶丶二小
搌	扌尸艹一フノㄟ
灶	火土
恶	亚心
孓	フ丨ㄟ
估	亻十口
俨	亻严
毂	士冖车几又
尖	小大
匦	匚车九
搠	扌丷一フ丨ノ月
攻	工攵
塘	土广フ一一丨口
搞	扌亠口冂口
塮	156
鼓	士口丷一十又
摁	扌囗大心
摅	扌虍心
炸	火乍
悸	忄禾子
壹	士冖一口丷一
趑	土丨一人冫人
痂	疒力口
趔	土丨一人歹刂
邸	氐阝
裹	亠果𧘇
搏	扌甫寸
炮	火勹巳
肮	月亠几
邮	由阝
填	土十具上八
蓊	艹八厶习习
铊	钅宀匕
肆	一丨一二厶聿
桷	木用
宓	宀必
佰	亻百
彰	立日十ノノノ
韫	韦日皿
瑙	王フフフノ囗乂
衷	亠中𧘇
顷	比左一ノ冂人
梧	木五口
祁	礻阝
拚	156
奁	大匚乂
瑕	王フ一丨一一フ一又
骛	フ丨ノ攵马
瑗	王ノ⺍一又
瑜	王人一月刂
瑀	王禹
瑰	王鬼
禹	ノ丨フ一丨フ丨一丶
峋	山勹日
妹	女未
砧	石丨一口
瑞	王山而
喂	口田一フノㄟ
觌	十フ丶丶大冂见下
鹉	一弋止鸟
瑚	王十口月
瑟	王王必
耢	耒艹冖力
玕	王干
缗	纟民日
钊	钅刂
寓	宀禺
骗	马户冂艹
砷	石申
样	木羊
缕	纟米女
诓	讠匚王
篓	米女
排	扌非
礁	石亻亠灬
悦	忄丷口儿
兀	一儿
伞	人丶ノ十
缑	纟亻フ一矢
缏	156
缌	纟田心
缉	纟口耳
啊	口阝丁口
穹	宀八弓
缈	纟目少
驹	马勹口
矧	矢弓丨
耦	耒禺
逦	辶丽
券	刀
彘	フフ一矢比左匕
缃	纟木目
守	宀寸
虺	兀虫
镊	钅耳又又
毕	比左匕十
菼	艹火火
蕊	艹心心心
媚	女フ丨一ノ目
氓	亡民
婷	女亠口冖丁
谓	讠田月
述	辶术
逶	辶禾女
媛	女ノ⺍一又
嫂	女ノ丨一フ一一丨又
七	一フ
布	巾
见	冂见下
私	禾厶
奄	大电
陂	阝フノ丨又
荚	艹夹
媒	女甘木
洨	氵亠八乂
隘	阝丷一八皿
质	ノノ十冂人
环	王不
眚	生目
骘	阝止丨ノノ马
逑	辶求
佛	亻弗
巽	巳巳艹一八
荦	艹冖牛
疝	疒山
砰	石平
姥	女耂匕
堰	土匚日女
强	弓口虫
孱	尸子子子
笸	匚口
欸	厶矢人
屡	尸米女
属	尸禹
钆	钅フ
寂	宀上小又
塈	156
谧	讠必皿
芾	艹一丨フ丨
乃	フノ
褊	衤户冂艹
昂	日ノフ卩
阂	门亠フノ人
谤	讠亠丷冖方
县	且厶
谣	讠ノ⺍缶
糨	米弓口虫
供	亻艹一八
埚	土口内
怙	忄十口
龚	龙艹一八
称	禾小
谠	讠冖口儿
祺	礻其上八
踞	尸十口
镝	钅亠丷冂十口
歧	止十又
玦	王夬guài
裥	衤门日
辛	立十
龛	人一口龙
裤	衤广车
裕	衤八人口
裣	衤人一⺍一
揿	扌钅人
跃	夭
卦	土土卜
痊	疒人王
趋	土丨一人彐
谟	讠艹日大
溃	氵中一冂人
盂	于皿
寐	宀爿未
沱	氵宀匕
窗	宀八ノ囗夂
窝	宀八口内
富	宀一口田
蛐	虫曲
唯	口亻亠
割	宀丰口刂
枚	木攵
愔	忄立日
锯	钅尸十口
讨	讠寸
箨	扌又一一丨
支	十又
卜	丨丶
欧	匚乂人
愎	忄ノ一日夂
苦	艹十口
进	辶井
愀	忄禾火
械	木戈廾
惴	忄山而
政	正攵
唿	口勿心
喊	口戌口
愦	忄中一冂人
丞	了フノㄟ一
淋	氵木木
愠	忄日皿
跋	又丶
练	纟一フフノ丶
暂	车斤日
惰	忄工月
仃	亻丁
慌	忄艹亡ノ丨フ
锿	钅亠口𧘇
趸	万口丨一人
蚂	虫马
卯	ノフノ卩
捯	扌一厶土刂
獯	犭ノ一丨フ丶ノ一丨一一灬
药	艹纟勺
湄	氵フ丨一ノ目
渥	氵尸一厶土
唱	口日日
渲	氵宀一日一
涞	氵来
镒	钅丷一八皿
痞	疒不口
衰	亠丨フ一一𧘇
湔	氵丷一月刂
游	氵方ノ一子
硚	石夭ノ丨
湾	氵亠丨丨ノ丶弓
下	一卜
渝	氵人一月刂
溆	氵人余下又
绺	纟夂卜口
湫	氵禾火
湃	氵一丰
弋	一フ丶
雉	矢亻亠
蛉	虫人丶
盉	禾皿
湍	氵山而
弊	丶ノ丨フ丨ノ丶攵廾
伊	亻尹
温	氵日皿
弃	亠厶廾
卿	ノフノ即左卩
湿	氵日业
艮	彐フノㄟ
湨	156
湝	氵比左匕白
湎	氵面
芷	艹止
犷	犭广
浓	氵农
锒	钅良
赓	广フ一一ノㄟ冂人
湮	氵西土
钝	钅屯
渣	氵木日一
牦	牛毛
泞	氵宀丁
咝	口丝
湘	氵木目
之	丶フㄟ
湖	氵十口月
滞	氵带上冖巾
抿	扌民
尸	フ一ノ
瘊	疒亻フ一矢
昊	日天
蜂	虫夂丰
鹈	丷フ一フ丨ノ鸟
焙	火立口
焜	火日比左匕
佃	亻田
献	十冂丷干犬
道	辶丷一自
匮	匚中一冂人
芮	艹内
驯	马川
烷	火宀二儿
铚	钅一厶土
涓	氵口月
痒	疒羊
奠	丷酉大
嗒	口艹人一口
尊	丷酉寸
粞	米西
翔	习习
阕	门フ丶ノノㄟ天
麋	广フ丨丨一比左匕米
贞	丨一冂人
崞	山亠口子
哚	口几木
庋	广十又
沔	氵丏
益	丷一八皿
蛊	虫皿
邕	フフフ口巴
诸	讠耂日
勿	勹ノノ
拿	人一口手
杉	木ノノノ
床	广木
蝉	虫丷丨フ一一一丨
较	车亠八乂
埂	土更
颏	亠フノ人一ノ冂人
牮	亻弋牛
侃	亻口ノ丨フ
啻	亠丷冖巾口
泛	氵乏
刷	尸巾刂
启	户口
爷	八乂卩
户	丶尸
瓿	立口瓦
舷	舟亠幺
童	立里
锝	钅日一寸
鄌	广フ一一丨口阝
痛	疒用
汞	工水
唝	口工冂人
咚	口夂丶丶
痧	疒氵少
滋	氵丷一幺幺
揍	扌寿上ㄟ天
蚊	虫文
绋	纟弗
霉	雨ノ一母
斌	文一弋止
介	人ノ丨
裒	亠臼𧘇
圉	囗土丷干
有	月
眉	フ丨一ノ目
蜉	虫ノ⺍子
媸	女フ丨丨一虫
垂	ノ一丨一丨丨一一
促	亻口丨一人
今	人丶フ
蛮	亠丨丨ノ丶虫
专	一一フ丶
洛	氵夂口
晒	日西
装	冫丨士亠𧘇
饰	饣ノ一巾
萎	艹禾女
馋	饣丨フ一ノフ丶丶
铝	钅口口
趾	止
祚	礻乍
馇	饣木日一
哝	口农
崛	山尸出
秧	禾央
蓝	艹丨丨ノ一丶皿
觞	用ノ一フノノ
飓	几乂具上八
坊	土方
猴	犭亻フ一矢
桂	木土土
承	フ丨一一一フノㄟ
猾	犭骨
豸	ノ丶丶ノフノノ
嗉	口幺小
上	丨一一
洇	氵囗大
猹	犭木日一
猢	犭十口月
踊	用
痉	疒フ丶工
渊	氵ノ米丨
乓	丘丶
鲃	鱼巴
憷	忄木木フ丨一人
冷	冫人丶
鲁	鱼日
猊	犭臼儿
鲀	鱼屯
鱿	鱼尤
薯	艹罒耂日
疯	疒几乂
腑	月广亻寸
脾	月ノ丨フ一一ノ十
蹓	156
腓	月非
斯	其上八斤
阒	门目犬
畦	田土土
涧	氵门日
厝	厂艹一日
厨	厂一口丷一寸
砂	石少
舜	ノ⺍冖夕一フ丨
郁	月阝
诞	讠亻一フ廴
禽	人亠乂凵丨フフ丶
贸	ノフ丶刀冂人
鹆	八人口鸟
番	ノ米田
靓	月冂见下
翕	人一口习习
驰	马也
琶	王王巴
库	广车
诺	讠艹口
弑	乂朩弋工
亓	二ノ丨
畲	人二小田
舒	人干口フ丨
艇	舟壬廴
艽	艹九
闯	门马
循	彳ノノ十目
绨	纟丷フ一フ丨ノ
培	土立口
嗯	口囗大心
旯	日九
盒	人一口皿
仨	亻三
街	彳土土亍
遁	辶ノノ十目
奥	ノ冂米大
皓	白口
泸	氵丨一尸
送	辶丷天
态	太心
遑	辶白王
例	亻歹刂
律	彳聿
藿	艹雨亻亠
闿	门山己
辋	车冂丷一亡
选	辶儿
焦	亻亠灬
傥	亻冖口儿
滓	氵宀立十
廓	广亠口子阝
仓	人フフ
姚	女儿冫ノ丶
傲	亻フノ攵
筝	フ一一丨
筋	月力
答	人一口
眯	目米
术	木丶
圯	土巳
筵	亻一フ廴
筏	亻戈
筅	儿
筒	冂一口
结	纟士口
吝	文口
策	一丨フ丨ノㄟ
紧	丨丨又幺小
洧	氵月
颂	八厶一ノ冂人
货	亻匕冂人
什	亻十
恁	亻壬心
筘	扌口
萑	艹亻亠
峒	山冂一口
等	土寸
垟	土羊
稂	禾良
稀	禾乂巾
程	禾口王
漓	氵亠乂凵丨フフ丶
缓	纟ノ⺍一又
具	具上八
青	月
颋	壬廴一ノ冂人
犊	牛十フ丶丶大
氯	气彐氺
毽	毛聿廴
畯	田厶八夂
轨	车九
镯	钅罒勹虫
毯	毛火火
毳	毛毛毛
氰	气月
矬	矢人人土
弓	フ一フ
奂	丨フ大
峧	山亠八乂
短	矢一口丷一
甥	生田力
菝	艹扌又丶
铑	钅耂匕
浸	氵彐冖又
畿	幺幺戈田
桊	木
哑	口亚
谒	讠日勹人フ
萜	艹巾丨一口
锐	钅丷口儿
骰	骨几又
锊	钅ノ⺍寸
锉	钅人人土
希	乂巾
锆	钅口
咯	口夂口
葶	艹亠口冖丁
拷	扌耂一フ
氨	气宀女
钯	钅巴
蒯	艹月月刂
啾	口禾火
哀	亠口𧘇
铼	钅来
铻	钅五口
铸	钅寿上寸
黑	丨フ丶ノ一丨一一灬
当	彐
体	亻本
丸	ノフ丶
鲧	鱼ノ幺小
芝	艹之
咿	口亻尹
沧	氵人フフ
呦	口幺力
赐	冂人日勿
嵋	山フ丨一ノ目
嵫	山丷一幺幺
栊	木龙
嵝	山米女
嵯	山工
蒿	艹亠口冂口
崽	山田心
抟	扌专
钿	钅田
输	车人一月刂
寨	宀一一丨丨一八朩
柒	氵七木
幅	巾一口田
诨	讠冖车
囚	囗人
嵘	山艹冖木
瓯	匚乂瓦
嵌	山甘人
喙	口フフ豕
喔	口尸一厶土
掊	扌立口
喧	口宀一日一
埒	土ノ⺍寸
嗞	口丷一幺幺
喽	口米女
钦	钅人
观	又冂见下
牝	牛匕
愁	禾火心
咦	口夷
鸳	夕フフ鸟
晦	日ノ一母
喻	口人一月刂
卑	ノ丨フ一一ノ十
脉	月永
婳	女一田凵
喤	口白王
铿	钅丨丨又土
荑	艹夷
岷	山民
殒	歹口冂人
鞒	革夭ノ丨
谷	八人口
瞒	目艹两
喟	口田月
廛	广里八土
喝	口日勹人フ
绛	纟夂一フ丨
敞	冂口攵
黛	亻弋黑
蛘	虫羊
蛟	虫亠八乂
纨	纟丸
垒	厶厶厶土
刃	刀丶
亨	亠口了
蛤	虫人一口
茝	艹匚丨口丨
猝	犭亠人人十
概	木即左一フノフ
如	女口
瘿	疒冂人冂人女
沸	氵弗
挝	扌寸辶
尧	一フノ兀
蛔	虫囗口
寒	宀一一丨丨一八丶丶
阿	阝丁口
酉	西一
茑	艹鸟
蛭	虫一厶土
挑	扌儿冫ノ丶
光	兀
邑	口巴
蛙	虫土土
倥	亻宀八工
跛	フノ丨又
汨	氵日
睚	目厂土土
伛	亻匚乂
坚	丨丨又土
跚	册
跞	乐
跗	亻寸
跌	失
跖	石
达	辶大
身	ノ丨フ一一一ノ
可	丁口
琦	王大丁口
诧	讠宀ノ七
幸	土丷干
晾	日亠口小
怜	忄人丶
喹	口大土土
否	不口
搦	扌弓冫弓冫
喳	口木日一
喋	口世木
炉	火户
肉	内人
叶	口十
悉	ノ米心
喷	口十艹冂人
揶	扌耳阝
鼎	目フ一ノ丨一丨フ
很	彳艮
踶	日一丨一人
陵	阝土八夂
砮	女又石
拤	扌上卜
铯	钅巴
濯	氵习习亻亠
妮	女尸匕
俯	亻广亻寸
赏	冖口冂人
棠	冖口木
喁	口禺
胍	月瓜
斐	非文
赂	冂人夂口
枉	木王
忿	八刀心
辈	非车
翘	一フノ兀习习
辎	车フフフ田
辍	车又又又又
栾	亠丨丨ノ丶木
砾	石乐
姞	女士口
侧	亻冂人刂
辌	车亠口小
椠	车斤木
辊	车日比左匕
玑	王几
睦	目土八土
憝	156
裂	歹刂亠𧘇
余	人余下
坫	土丨一口
跶	大辶
蟮	虫羊丷一口
矮	矢禾女
硝	石月
硬	石更
鲂	鱼方
貂	豸刀口
瑁	王冂一一目
沂	氵斤
鹂	丽鸟
酦	酉フノ又丶
淞	氵木八厶
酤	酉十口
徊	彳囗口
骒	马果
羊	丷一一一丨
桉	木宀女
扑	扌卜
剑	人一⺍一刂
矾	石凡
粟	西米
覃	西日十
垦	艮土
惑	戈口一心
鹁	十冖子鸟
轧	车フ
酝	酉二厶
慝	匚艹口心
稞	禾果
棣	木フ一一丨冫ノㄟ
闵	门文
溶	氵宀八人口
纶	纟人匕
棬	木フフ
椁	木亠口子
棚	木月月
椑	木ノ丨フ一一ノ十
萁	艹其上八
鳂	鱼田一フノㄟ
搁	扌门夂口
椎	木亻亠
难	又亻亠
庶	广廿灬
棍	木日比左匕
棹	木丨一日十
俊	亻厶八夂
堉	土亠厶月
栉	木艹卩
砉	丰石
岂	山己
我	ノ一丨一フノ丶
椒	木上小又
椅	木大丁口
亮	亠口冖几
园	囗二儿
弧	弓瓜
伧	亻人フフ
神	礻申
楞	木罒方
焚	木木火
襞	尸口立十亠𧘇
阵	阝车
蹶	厂丷一フ丨ノ人
瘵	疒ノフ丶丶二小
昵	日尸匕
椰	木耳阝
涨	氵弓长
棒	木寿上ㄟ一一丨
沌	氵屯
葭	艹フ一丨一一フ一又
朝	十日十月
铁	钅失
谂	讠人丶フ心
并	丷开
狉	犭丕
拉	扌立
勉	丨フ一ノフ力
苑	艹夕フフ
韩	十日十韦
虾	虫下
百	一白
葖	艹宀八犬
峂	山夂丶丶
亿	亻フ
肱	月厶
圭	土土
葱	艹匆心
眭	目土土
札	木フ
朦	月艹冖二ノフノノノㄟ
继	纟米フ
董	艹重
黧	禾勹ノ黑
萼	艹口口亏
遭	辶一丨フ一丨丨一日
卵	ノフ丶ノ卩丶
灭	一火
葛	艹日勹人フ
张	弓长
克	十口儿
惹	艹口心
求	一丨冫ノ丶ㄟ丶
璁	王ノ囗夂心
靸	革及
靰	革兀
葫	艹十口月
央	丨夬guài
鬶	夫冂见下一口冂丷一丨
抉	扌夬guài
葑	艹土土寸
芑	艹己
驴	马户
念	人丶フ心
搔	扌叉虫
摒	扌尸丷开
品	口口口
邝	广阝
肝	月干
炝	火人フフ
悝	忄里
座	广人人土
产	立ノ
恽	忄冖车
握	扌尸一厶土
揎	156
搅	扌⺍冖冂见下
肭	月内
炭	山火
悭	忄丨丨又土
搂	扌米女
搓	扌工
揞	156
裁	十戈亠𧘇
塆	土亠丨丨ノ丶弓
骊	马丽
搀	扌丨フ一ノフ丶丶
匝	匚巾
捉	扌口丨一人
卉	十廾
草	艹日十
堠	土亻フ一矢
搜	扌ノ丨一フ一一丨又
慑	忄耳又又
兑	丷口儿
插	扌千臼
塄	土罒方
揣	扌山而
馒	饣日罒又
层	尸二厶
礞	石艹冖二ノフノノノㄟ
邽	土土阝
肽	月太
恝	丰刀心
颉	士口一ノ冂人
揾	扌曰皿
博	十甫寸
堤	土日一丨一人
家	宀豕
萸	艹臾
莰	艹土人
超	土丨一人刀口
垮	土大亏
勒	革力
猁	犭禾刂
软	车人
叔	上小又
揩	扌比左匕白
揸	扌木日一
佯	亻羊
塃	156
按	扌宀女
沟	氵勹厶
讶	讠牙
塔	土艹人一口
秒	禾少
使	亻吏
姒	女フ丶人
捞	扌艹冖力
阉	门大电
轿	车夭ノ丨
齿	止人凵
殂	歹且
帧	巾丨一冂人
款	士二小人
痦	疒五口
揳	扌丰刀大
鼋	二儿口电
丧	十丷一フノㄟ
罘	罒不
琬	王宀夕フフ
逭	辶宀㠯
琯	王宀㠯
崖	山厂土土
菁	艹月
倭	亻禾女
蝮	虫ノ一日夂
羯	日勹人フ
釉	ノ米由
琨	王日比左匕
侯	亻フ一矢
樊	木乂乂木大
琪	王其上八
挠	扌一フノ兀
茵	艹囗大
画	一田凵
凑	冫寿上ㄟ天
琫	王寿上ㄟ一一丨
缁	纟フフフ田
便	亻更
郝	土ノ丨ノ丶阝
松	木八厶
缀	纟又又又又
耽	耳丶フノフ
巧	工一フ
持	扌土寸
烝	了フノㄟ一灬
胝	月氐
息	自心
绾	纟宀㠯
绽	纟宀一丨一人
绻	纟フフ
六	亠八
也	フ丨フ
忧	忄尤
湟	氵白王
绸	纟冂土口
绷	纟月月
魂	二厶鬼
绳	纟口电
绲	纟日比左匕
绰	纟丨一日十
芰	艹十又
冬	夂丶丶
骑	马大丁口
续	纟十フ丶丶大
遥	辶ノ⺍缶
腭	月口口亏
颈	フ丶工一ノ冂人
纸	纟氏
脍	月人二厶
永	丶フフノㄟ
膑	月宀丘八
醑	酉フ丨一人月
婵	女丷丨フ一一一丨
婚	女氏日
樾	木土丨一人戈フ
喉	口亻フ一矢
婞	女土丷干
叁	厶大三
迷	辶米
鹊	艹一日鸟
訾	止匕亠一一口
酽	酉严
亟	了口又一
隗	阝鬼
骂	口口马
废	广フノ又丶
粜	出米
隈	阝田一フノㄟ
随	阝月辶
隋	阝工月
屠	尸耂日
尉	尸二小寸
敢	フ耳攵
逐	辶豕
耐	而寸
癞	疒束冂人
桑	又又又木
韦	一一フ丨
谝	讠户冂艹
谚	讠产ノノノ
谗	讠丨フ一ノフ丶丶
谕	讠人一月刂
祷	礻寿上寸
渔	氵鱼
洼	氵土土
袱	衤亻犬
秾	禾农
裆	衤彐
矶	石几
啉	口木木
邵	刀口阝
屎	尸米
陉	阝フ丶工
越	土丨一人戈フ
惭	忄车斤
热	扌丸灬
胭	月囗大
仟	亻千
谏	讠柬
谍	讠世木
谌	讠其上八フ
窑	宀八缶
窒	宀八一厶土
宿	宀亻百
遐	辶フ一丨一一フ一又
寄	宀大丁口
砑	石牙
寅	宀一由八
统	纟亠厶儿
恐	工凡心
寇	宀二儿丨一又
惯	忄フフノ一冂人
惮	忄丷丨フ一一一丨
悄	忄月
惦	忄广丨一口
惇	忄亠口子
惚	忄勿心
惟	忄亻亠
烽	火夂丰
能	厶月匕匕
都	耂日阝
嘉	士口丷一力口
牁	爿丁口
扁	户冂艹
剁	几木刂
梾	木来
急	彐心
回	囗口
伟	亻韦
衮	亠八厶𧘇
惧	忄具上八
惝	忄冂口
悼	忄丨一日十
惜	忄艹一日
爻	乂乂
飑	几乂勹巳
情	忄月
去	土厶
狴	犭比左匕土
壑	丨一冖一八人口又土
蛞	虫千口
缟	纟亠口冂口
淬	氵亠人人十
邈	辶豸白儿
裉	衤艮
磉	石又又又木
棉	木白巾
傈	亻西木
淮	氵亻亠
妒	女户
衾	人丶フ亠𧘇
怵	忄术
涸	氵囗十口
顾	厂フフ一ノ冂人
混	氵日比左匕
淏	氵日天
顶	丁一ノ冂人
耵	耳丁
镵	钅口比左匕丨フ一ノフ丶
渐	氵车斤
渠	氵巨木
冰	冫水
扭	扌丑
垞	土宀ノ七
枞	木人人
贶	冂人口儿
郐	人二厶阝
酥	酉禾
冗	冖几
悟	忄五口
纥	纟乞
淇	氵其上八
碑	石ノ丨フ一一ノ十
倡	亻日日
郈	ノノ一口阝
渍	氵冂人
烈	歹刂灬
清	氵月
墉	土广フ一一丨フ一一丨
娥	女我
玷	王丨一口
酗	酉乂凵
炎	火火
纹	纟文
剃	丷フ一フ丨ノ刂
焕	火丨フ大
烯	火乂巾
焊	火日干
狁	犭厶儿
挪	扌フ一一ノ阝
敝	丶ノ丨フ丨ノ丶攵
兽	丷田一口
剪	丷一月刂刀
断	米フ斤
坞	土乌
喵	口艹田
劭	刀口力
杞	木己
龟	丨フ一一フ
辒	车日皿
睑	目人一⺍一
村	木寸
君	尹口
鸥	匚乂鸟
夜	亠亻ノフ丶ㄟ
粘	米丨一口
粝	米厂万
祉	礻止
迩	辶小
妨	女方
盖	皿
羟	フ丶工
愈	人一月刂心
奉	寿上ㄟ一一丨
羚	人丶
戋	一一フノ丶
着	目
岗	山冂乂
迈	辶万
劁	亻亠灬刂
秘	禾必
犁	禾刂牛
祀	礻巳
工	一丨一
凭	亻壬几
卷	フフ
汰	氵太
翟	习习亻亠
俟	亻厶矢
堞	土世木
胁	月办
阇	门耂日
迟	辶尺
脞	月人人土
袤	亠フ丨ノ𧘇
臭	自犬
望	亡月王
啵	口氵フノ丨又
喏	口艹口
腈	月月
佬	亻耂匕
商	亠丷冂八口
坑	土亠几
翊	立习习
先	儿
慈	丷一幺幺心
章	立日十
妾	立女
鹿	广フ丨丨一比左匕
禾	ノ木
茼	艹冂一口
馀	156
赧	土ノ丨ノ丶卩又
廊	广丶即左阝
肇	户攵聿
巨	匚フ一
楮	木耂日
刭	フ丶工刂
赶	土丨一人干
柞	木乍
疵	疒止匕
社	礻土
缒	纟ノ㠯辶
柑	木甘
鼒	才目フ一ノ丨一丨フ
蟑	虫立日十
砜	石几乂
违	辶韦
庾	广臾
饮	饣人
仰	亻ノフ卩
测	氵冂人刂
烹	亠口了灬
孰	亠口子丸
毫	亠口冖毛
忒	弋心
怿	忄又一一丨
弥	弓小
刽	人二厶刂
馆	饣宀㠯
爽	大乂乂乂乂
戽	户丶丶十
馃	饣果
殴	匚乂几又
遇	辶禺
胴	月冂一口
钞	钅少
怯	忄土厶
莉	艹禾刂
猕	犭弓小
宽	宀艹冂见下
江	氵工
璞	王业ㄟ
讴	讠匚乂
斛	用丶丶十
瞑	目冖日亠八
凰	几白王
鞑	革大辶
猫	犭艹田
逢	辶夂丰
栓	木人王
猜	犭月
逸	辶丨フ一ノフ丶
够	勹口夕夕
灸	久火
鱾	鱼己
枷	木力口
匐	勹一口田
倚	亻大丁口
师	丨ノ一巾
妁	女勺
卮	ノノ一フフ
讯	讠フ十
要	西女
珉	王民
揉	扌フ丨ノ木
叉	又丶
压	厂十一丶
埘	土日寸
鲟	鱼彐寸
脶	月口内
豚	月豕
报	扌卩又
孽	艹ノ㠯立十子
芥	艹人ノ丨
秦	寿上ㄟ禾
掩	扌大电
砻	龙石
失	ノ夫
彩	ノ⺍木ノノノ
打	扌丁
么	ノ厶
瓻	乂巾瓦
升	ノ廾
卫	卩一
鸽	人一口鸟
饿	饣我
斜	人余下丶丶十
坷	土丁口
杷	木巴
厉	厂万
归	丨ノ彐
莼	艹纟屯
掮	扌户月
玮	王韦
旅	方ノ一ノフノㄟ
退	辶艮
玉	王丶
硁	石フ丶工
届	尸由
诊	讠人ノノノ
换	扌丨フ大
锞	钅果
唳	口户犬
阑	门柬
盘	舟皿
拭	扌弋工
狭	犭夹
罢	罒土厶
舸	舟丁口
衔	彳钅亍
得	彳日一寸
徘	彳非
切	七刀
鸻	彳亍鸟
恹	忄厂犬
蜷	虫フフ
眷	目
纰	纟比左匕
假	亻フ一丨一一フ一又
兜	白ノフフ一儿
袂	衤夬guài
躯	身匚乂
偻	亻米女
哮	口耂子
停	亻亠口冖丁
互	一フフ一
知	矢口
拼	扌丷开
贯	フフノ一冂人
瓮	八厶瓦
码	石马
砘	石屯
偷	亻人一月刂
偲	亻田心
铞	钅口巾
负	冂人
监	丨丨ノ一丶皿
戥	日生戈
哞	口厶牛
驮	马大
茭	艹亠八乂
饬	饣ノ一力
偶	亻禺
偕	亻比左匕白
肿	月中
鸺	亻木鸟
咋	口乍
做	亻十口攵
偾	亻十艹冂人
雷	雨田
钋	钅卜
庙	广由
笞	厶口
笾	力辶
曷	日勹人フ
廒	广フノ攵
售	亻亠口
傀	亻鬼
第	フ一フ丨ノ
炀	火フノノ
吉	士口
竽	于
琉	王亠厶ノ丨フ
盈	乃又皿
符	亻寸
荥	艹冖水
溉	氵即左一フノフ
皑	白山己
争	フ一一丨
笮	乍
笙	生
沽	氵十口
呼	口乎
卓	丨一日十
笛	由
笪	日一
呋	口夫
拧	扌宀丁
韨	韦又丶
怅	忄长
呻	口申
速	辶束
炖	火屯
绔	纟大亏
鲽	鱼世木
笺	戋
粽	米宀二小
房	户方
好	女子
囟	ノ囗乂
墁	土日罒又
梁	氵刀ノ丶木
烀	火乎
胀	月长
扶	扌夫
玥	王月
皈	白ノノ又
髦	一丨一二厶ノノノ毛
廉	广丷一フ一一丨丨ノㄟ
仉	亻几
牾	牛五口
矫	矢夭ノ丨
杰	木灬
乌	ノフフ一
汽	氵气
银	钅艮
铵	钅宀女
灯	火丁
凫	ノフ丶フ几
厥	厂丷一フ丨ノ人
右	口
另	口力
铲	钅产
辂	车夂口
睁	目フ一一丨
钼	钅目
徂	彳且
籽	米子
铱	钅亠𧘇
祠	礻フ一口
乒	丘ノ
乞	ノ一フ
暑	日耂日
铮	钅フ一一丨
驷	马囗儿
铬	钅夂口
状	冫丨犬
讦	讠干
杈	木叉
拥	扌用
锑	钅丷フ一フ丨ノ
妇	女彐
贩	冂人ノノ又
尽	尺丶丶
伉	亻亠几
涝	氵艹冖力
铨	钅人王
寿	寿上寸
汾	氵八刀
娠	女厂二フノㄟ
宦	宀臣
浥	氵口巴
浕	氵尺丶丶
霁	雨文ノ丨
尘	小土
省	少目
迂	辶于
脊	冫ノ丶人月
濂	氵广丷一フ一一丨丨ノㄟ
洚	氵夂一フ丨
啪	口扌白
谯	讠亻亠灬
氽	156
凶	乂凵
叮	口丁
稷	禾田八夂
救	求攵
犴	犭干
坛	土二厶
鸟	乌丶
圈	囗フフ
猥	犭田一フノㄟ
挥	扌冖车
香	禾日
婴	冂人冂人女
赈	冂人厂二フノㄟ
吼	口子フ
赇	冂人求
崆	山宀八工
崇	山宀二小
崤	山乂月
学	⺍冖子
崟	山金
圃	囗甫
崮	山囗十口
岩	山石
缂	纟革
古	十口
咒	口口几
崦	山大电
捆	扌囗木
柁	木宀匕
异	巳廾
琮	王宀二小
误	讠口天
吮	口厶儿
制	ノ一一丨フ丨刂
捶	扌垂
父	八乂
舶	舟白
唑	口人人土
啷	口丶即左阝
鸲	勹口鸟
趿	及
运	辶二厶
浠	氵乂巾
呵	口丁口
啥	口人干口
啤	口ノ丨フ一一ノ十
葵	艹フ丶ノノㄟ天
醉	酉亠人人十
犯	犭フフ
鄂	口口亏阝
累	田幺小
唬	口虍几
啼	口亠丷冖巾
陇	阝龙
罂	冂人冂人缶
蛀	虫主
鞁	革フノ丨又
逞	辶口王
凉	冫亠口小
泔	氵甘
涯	氵厂土土
极	木及
簦	156
谦	讠丷一フ一一丨丨ノㄟ
榷	木丶フノ丨亠
其	其上八
嗑	口土厶皿
弘	弓厶
办	力ノ丶
洒	氵西
吁	口于
俳	亻非
祟	出二小
蛄	虫十口
蚶	虫甘
轩	车干
啮	口止人凵
撵	扌夫夫车
钵	钅本
扉	户非
馊	饣ノ丨一フ一一丨又
趺	夫
於	方人丶丶
疼	疒夂丶丶
趼	开
高	亠口冂口
疮	疒人フフ
晁	日儿冫ノ丶
啡	口非
啭	口车专
晚	日丨フ一ノフ
冉	丨フ丨一一
饷	饣ノ冂口
浯	氵五口
详	讠羊
窟	宀八尸出
冶	冫厶口
钥	钅月
晞	日乂巾
喑	口立日
浒	氵讠午
剞	大丁口刂
萤	艹冖虫
谑	讠虍一フ一
呐	口内
民	フ一フ一フ
荸	艹十冖子
此	止匕
牧	牛攵
叵	匚口
槊	丷一フ丨ノ月木
啦	口扌立
洽	氵人一口
哼	口亠口了
圊	囗月
野	里フ丨
南	十冂丷干
坨	土宀匕
目	囗一一
绂	纟又丶
仂	亻力
伯	亻白
贽	扌丸冂人
斧	八乂斤
妊	女壬
阁	门夂口
惶	忄白王
夷	一フ一フノㄟ
珥	王耳
菥	艹木斤
句	勹口
挞	扌大辶
尤	尢丶
末	一一丨ノㄟ
荜	艹比左匕十
琐	王冂人
搐	扌亠幺田
吐	口土
琵	王王比左匕
铉	钅亠幺
吵	口少
紊	文幺小
晨	日厂二フノㄟ
览	丨丨ノ一丶冂见下
唼	口立女
泽	氵又一一丨
啧	口冂人
眦	目止匕
眶	目匚王
常	冖口巾
市	亠巾
绯	纟非
毙	比左匕歹匕
圮	土己
雁	厂亻亻亠
蔼	艹讠日勹人フ
蜮	虫戈口一
姊	女ノフ丨ノ
抽	扌由
鬟	一丨一二厶ノノノ罒一口𧘇
苞	艹勹巳
狞	犭宀丁
卖	十フ丶丶大
屦	尸彳米女
龁	止人凵乞
堑	车斤土
哐	口匚王
擐	扌罒一口𧘇
粑	米巴
蓐	艹厂二フノㄟ寸
钉	钅丁
雨	一丨フ丨丶丶丶丶
纩	纟广
赊	冂人人二小
弄	王廾
妈	女马
雩	雨亏
尝	冖二厶
萦	艹冖幺小
殍	歹ノ⺍子
霾	雨豸里
殓	歹人一⺍一
绿	纟彐氺
幂	冖日大巾
圾	土及
沛	氵一丨フ丨
蚁	虫义
仿	亻方
斗	丶丶十
盔	火皿
茏	艹龙
哉	十戈口
鸸	而鸟
略	田夂口
账	冂人长
镥	钅鱼日
鲯	鱼其上八
硐	石冂一口
驱	马匚乂
咐	口亻寸
池	氵也
璐	王夂口
貊	豸百
硕	石一ノ冂人
硒	石西
鲊	鱼乍
硅	石土土
祥	礻羊
陪	阝立口
镁	钅大
周	冂土口
五	一丨フ一
涂	氵人余下
啁	口冂土口
蛾	虫我
盾	ノノ十目
曾	丷囗日
图	囗夂丶丶
敕	束攵
曹	一丨フ一丨丨一日
放	方攵
令	人丶
卞	丶下
浊	氵虫
疥	疒人ノ丨
斥	ノノ一丨丶
铐	钅耂一フ
荞	艹夭ノ丨
梭	木厶八夂
钮	钅丑
桶	木用
仄	厂人
逊	辶子小
棂	木彐火
荐	艹丨子
协	十办
捐	扌口月
笑	夭
桫	木氵少
棁	木丷口儿
锁	钅冂人
谁	讠亻亠
帽	巾冂一一目
丽	一丨フ丶丨フ
唁	口亠一一口
梢	木月
闼	门大辶
问	门口
踯	丷天阝
郴	木木阝
旮	九日
苜	艹目
吏	一丨フ一ノㄟ
斫	石斤
润	氵门王
綦	其上八幺小
敉	米攵
吞	天口
吧	口巴
梦	木木夕
诟	讠ノノ一口
铥	钅ノ土厶
孑	フ丨一
赳	土丨一人フ丨
黄	艹一由八
谊	讠宀且
魑	鬼亠乂凵丨フフ丶
剂	文ノ丨刂
筑	工凡
牂	爿羊
营	艹冖口口
刳	大亏刂
汩	氵曰
拮	扌士口
旁	亠丷冖方
崂	山艹冖力
昼	尺日一
瘼	疒艹日大
阮	阝二儿
阼	阝乍
菠	艹氵フノ丨又
路	夂口
巯	フ丶工亠厶ノ丨フ
臣	匚丨フ一丨
妙	女少
萄	艹勹缶
珞	王夂口
氟	气弗
唉	口厶矢
泊	氵白
鸠	九鸟
枧	木冂见下
锥	钅亻亠
赦	土ノ丨ノ丶攵
修	亻丨夂ノノノ
棻	艹八刀木
埠	土ノ㠯十
垭	土亚
提	扌日一丨一人
珐	王土厶
庵	广大电
亵	亠扌丸𧘇
柈	木半
掭	扌天
侉	亻大亏
徉	彳羊
鸦	牙鸟
萝	艹罒夕
辉	兀冖车
郏	夹阝
带	带上冖巾
萌	艹日月
狂	犭王
菖	艹日日
菽	艹上小又
菲	艹非
勚	世冂人力
趁	土丨一人人ノノノ
纵	纟人人
晴	日月
陴	阝ノ丨フ一一ノ十
伸	亻申
迮	辶乍
翮	一口冂丷一丨习习
枭	ノフ丶フ木
忮	忄十又
娶	耳又女
妗	女人丶フ
炽	火口八
纳	纟内
篑	中一冂人
掐	扌臼
聃	耳冉
译	讠又一一丨
职	耳口八
意	立日心
忉	忄刀
据	扌尸十口
埽	土彐冖巾
颟	艹两一ノ冂人
纺	纟方
脏	月广土
淦	氵金
左	工
捩	扌户犬
碟	石世木
接	扌立女
喀	口宀夂口
氛	气八刀
掂	扌广丨一口
暴	日艹一八氺
皴	厶八夂フノ丨又
蚴	虫幺力
恸	忄二厶力
板	木ノノ又
睿	丨一冖一八人目
轸	车人ノノノ
杭	木亠几
弭	弓耳
鸷	扌丸鸟
缭	纟大丶ノ日小
漭	氵艹犬廾
桅	木厂フフ
教	耂子攵
堋	土月月
埝	土人丶フ心
授	扌ノ⺍冖又
偏	亻户冂艹
案	宀女木
灏	氵日亠口小一ノ冂人
剐	口内刂
遏	辶日勹人フ
麦	夂
它	宀匕
约	纟勺
郾	匚日女阝
度	广廿又
日	囗一
椿	木寿上ㄟ日
亦	亠ノ丨ノ丶
逵	辶土八土
伺	亻フ一口
间	门日
踵	重
痴	疒矢口
珂	王丁口
芽	艹牙
呀	口牙
堆	土亻亠
堌	土囗十口
夙	几歹
圬	土亏
本	一丨ノㄟ一
眬	目龙
芊	艹千
嘴	口止匕用
轾	车一厶土
掉	扌丨一日十
焉	正一フ灬
姓	女生
舐	千口氏
栈	木戋
成	戊フ
掎	扌大丁口
域	土戈口一
鹦	冂人冂人女鸟
胞	月勹巳
瘥	疒工
春	寿上ㄟ日
汁	氵十
书	フフ丨丶
你	亻小
堵	土耂日
柽	木又土
践	戋
阴	阝月
昴	日ノフノ卩
瘴	疒立日十
屁	尸比左匕
夹	一丶ノ一ノㄟ
笫	ノフ丨ノ
历	厂力
贳	世冂人
衍	彳氵亍
鸶	丝鸟
骏	马厶八夂
偬	亻匆心
呤	口人丶
馁	饣ノ⺍女
绦	纟夂朩
狐	犭瓜
忤	忄午
段	ノ丨一一一几又
却	土厶卩
囝	囗子
绢	纟口月
勐	子皿力
拐	扌口力
沁	氵心
芪	艹氏
伦	亻人匕
弦	弓亠幺
狈	犭冂人
苈	艹厂力
蝥	フ丨ノ攵虫
拈	扌丨一口
杖	木丈
骋	马由一フ
哂	口西
皿	丨フ丨丨一
剟	又又又又刂
兮	八一フ
莸	艹犭尤
岁	山夕
拒	扌巨
对	又寸
畚	厶大田
哿	力口丁口
毋	フフノ一
催	亻山亻亠
真	十具上八
恕	女口心
垄	龙土
竑	立厶
孵	卵ノ⺍子
掴	扌囗玉
努	女又力
娟	女口月
岑	山人丶フ
劐	艹亻亠又刂
糁	米厶大ノノノ
饹	饣夂口
鳁	鱼日皿
研	石开
芈	丨一丨一一一丨
枥	木厂力
酞	酉太
嫉	女疒矢
囿	囗月
邬	乌阝
悬	且厶心
炬	火巨
蚩	フ丨丨一虫
岳	丘山
峁	山ノフノ卩
河	氵丁口
大	ㄟ
砝	石土厶
奘	爿士大
吊	口巾
位	亻立
屑	尸月
展	尸艹一フノㄟ
剥	彐氺刂
拴	扌人王
怕	忄白
邦	寿上阝
冤	冖丨フ一ノフ丶
莺	艹冖鸟
冥	冖日亠八
腐	广亻寸内人
酐	酉干
侦	亻丨一冂人
轰	车又又
邶	丨一一匕阝
仞	亻刃
午	ノ干
芼	艹毛
苴	艹且
租	禾且
庸	广フ一一丨フ一一丨
亸	亠口子丷丨フ一一一丨
坎	土人
自	ノ目
麸	夂夫
凸	丨一丨フ一
轮	车人匕
荀	艹勹日
匆	勹ノノ丶
被	衤フノ丨又
栩	木习习
侮	亻ノ一母
袍	衤勹巳
袒	衤日一
铀	钅由
诽	讠非
焐	火五口
辰	厂二フノㄟ
契	丰刀大
冢	冖一ノフノノ丶ノㄟ
扅	户夕夕
桧	木人二厶
抚	扌无
脐	月文ノ丨
彦	产ノノノ
匀	勹冫
忏	忄千
亚	一业
挈	丰刀手
匈	勹乂凵
茈	艹止匕
茴	艹囗口
韭	非一
倾	亻比左一ノ冂人
爸	八乂巴
韧	韦刃
倬	亻丨一日十
逾	辶人一月刂
茀	艹弗
矿	石广
死	歹匕
俶	亻上小又
请	讠月
梵	木木凡
遴	辶米夕一フ丨
容	宀八人口
涉	氵止丨ノノ
痈	疒用
俦	亻寿上寸
公	八厶
恤	忄血
函	了冫ノ丶凵
耶	耳阝
馑	饣廿丨フ一一一丨一
宵	宀月
史	丨フ一ノㄟ
咎	夂卜口
宸	宀厂二フノㄟ
宁	宀丁
殁	歹几又
迦	辶力口
酬	酉州
讧	讠工
颥	雨而一ノ冂人
夫	一一ノㄟ
业	丨丨丶ノ一
妆	冫丨女
悛	忄厶八夂
珀	王白
菀	艹宀夕フフ
悔	忄ノ一母
车	一フ一丨
喈	口比左匕白
注	氵主
悴	忄亠人人十
浚	氵厶八夂
肴	乂月
页	一ノ冂人
旦	日一
从	人人
姑	女十口
憬	忄日亠口小
科	禾丶丶十
桥	木夭ノ丨
醐	酉十口月
觑	虍业冂见下
浪	氵良
珲	王冖车
定	宀一丨一人
芳	艹方
掀	扌斤人
劳	艹冖力
西	一丨フノフ一
补	衤卜
陟	阝止丨ノノ
芭	艹巴
涣	氵丨フ大
浮	氵ノ⺍子
拦	扌丷三
志	士心
证	讠正
篁	白王
过	辶寸
涔	氵山人丶フ
皂	白七
涡	氵口内
三	一二
涢	氵口冂人
浞	氵口丨一人
涠	氵囗韦
夭	ノ大
陈	阝东
期	其上八月
土	十一
哈	口人一口
挦	扌彐寸
娑	氵少女
奖	冫丨夕大
拾	扌人一口
勾	勹厶
歼	歹千
丘	ノ丨一丨一
浦	氵甫
陨	阝口冂人
所	ノノフ一斤
坂	土ノノ又
辘	车广フ丨丨一比左匕
剀	山己刂
烬	火尺丶丶
惬	忄匚夹
扦	扌千
胬	女又内人
烤	火耂一フ
郸	丷丨フ一一一丨阝
诬	讠工人人
柚	木由
钪	钅亠几
围	囗韦
嘈	口一丨フ一丨丨一日
义	丶乂
恙	心
湉	氵忄千口
阈	门戈口一
韵	立日勹冫
忘	亡心
查	木日一
錾	车斤金
俘	亻ノ⺍子
竿	干
扮	扌八刀
匾	匚户冂艹
芦	艹户
决	冫夬guài
沨	氵几乂
枫	木几乂
甙	156
旆	方ノ一一丨フ丨
冻	冫东
刀	フノ
还	辶不
竞	立口儿
绊	纟半
脬	月ノ⺍子
舀	ノ⺍臼
心	丶フ丶丶
垆	土丨一尸
级	纟及
苁	艹人人
竹	ノ一丨ノ一丨
正	一止
荬	艹フ丶丶大
奎	大土土
迹	辶亠ノ丨ノ丶
伋	亻及
艿	艹乃
颇	フノ丨又一ノ冂人
聆	耳人丶
碇	石宀一丨一人
郭	亠口子阝
裈	衤冖车
妥	ノ⺍女
优	亻尤
缘	纟フフ豕
莒	艹口口
飐	几乂丨一口
灾	宀火
凄	冫一フ一一丨女
皱	彐フノ丨又
杆	木干
袅	ノフ丶フ亠𧘇
磐	舟几又石
突	宀八犬
狼	犭良
骁	马一フノ兀
晌	日ノ冂口
咫	尺口八
涵	氵了冫ノ丶凵
啴	口丷丨フ一一一丨
趵	勺
畴	田寿上寸
瓦	一フフ丶
鱽	鱼刀
向	ノ冂口
昆	日比左匕
朕	月丷天
狎	犭甲
脑	月亠乂凵
胶	月亠八乂
硇	石ノ囗乂
透	辶禾乃
袈	力口亠𧘇
长	ノ一フㄟ
怏	忄央
坟	土文
束	一丨フ一丨ノㄟ
劬	勹口力
若	艹口
肾	丨丨又月
邾	朱阝
驭	马又
嫁	女宀豕
鸰	人丶鸟
犀	尸氺牛
技	扌十又
髁	骨果
耳	一丨丨一一一
豹	豸勺
劝	又力
豺	豸才
爹	八乂夕夕
疴	疒丁口
赵	土丨一人乂
瓞	瓜失
华	亻匕十
些	止匕二
舨	156
徕	彳来
徒	彳土丨一人
庚	广フ一一ノㄟ
倔	亻尸出
祈	礻斤
入	ノㄟ
呶	口女又
损	扌口冂人
砟	石乍
栟	木丷开
奈	大二小
亘	一日一
稿	禾亠口冂口
遗	辶中一冂人
材	木才
胤	ノ幺月フ
臬	自木
是	日一丨一人
倓	亻火火
臾	ノ丨一フ一一ノㄟ
允	厶儿
倦	亻フフ
岸	山厂干
铴	钅氵フノノ
休	亻木
坐	人人土
洵	氵勹日
仇	亻九
姣	女亠八乂
匕	ノフ
诒	讠厶口
倍	亻立口
毒	母
小	丨ノ丶
戾	户犬
隽	亻亠乃
弛	弓也
倪	亻臼儿
晟	日成
戬	亚日戈
愤	忄十艹冂人
绘	纟人二厶
付	亻寸
倞	亻亠口小
邗	干阝
倏	亻丨夂犬
网	冂乂乂
朐	月勹口
爬	爪巴
般	舟几又
舾	舟西
妣	女比左匕
发	フノ又丶
挢	156
锴	钅比左匕白
债	亻冂人
壶	士冖业
佑	亻口
刎	勿刂
泵	石水
荽	艹ノ⺍女
笆	巴
秀	禾乃
笊	爪
怎	乍心
秕	禾比左匕
秩	禾失
积	禾口八
坦	土日一
秣	禾末
殆	歹厶口
怍	忄乍
茨	艹冫人
尾	尸毛
宫	宀口口
特	牛土寸
某	甘木
荭	艹纟工
辑	车口耳
捭	扌ノ丨フ一一ノ十
殉	歹勹日
珈	王力口
氧	气羊
又	フㄟ
氦	气亠フノ人
钟	钅中
缺	缶夬
改	己攵
铆	钅ノフノ卩
帘	宀八巾
侑	亻月
窥	宀八夫冂见下
榀	156
莽	艹犬廾
篾	罒戍
乘	千丨一一匕ノㄟ
柜	木巨
岫	山由
初	衤刀
钴	钅十口
钲	钅正
唔	口五口
赅	冂人亠フノ人
赃	冂人广土
觊	山己冂见下
线	纟戋
峨	山我
妞	女丑
诮	讠月
析	木斤
逗	辶一口丷一
近	辶斤
罟	罒十口
抵	扌氐
罡	罒正
旱	日干
鹘	骨鸟
凤	几又
邹	彐阝
诉	讠斥
场	土フノノ
护	扌户
忑	下心
俑	亻用
唤	口丨フ大
鸯	央鸟
邙	亡阝
炙	ノフ丶丶火
血	ノ皿
拽	扌曳
桀	夕一フ丨木
础	石出
盎	央皿
恩	囗大心
哦	口我
少	小ノ
壮	冫丨士
蚝	虫毛
独	犭虫
括	扌千口
帑	女又巾
渑	氵口电
蚍	虫比左匕
丑	フ丨一一
岔	八刀山
呈	口王
摈	扌宀丘八
簉	口辶
剔	日勿刂
诂	讠十口
茉	艹末
锟	钅日比左匕
限	阝艮
生	ノ
涘	氵厶矢
虐	虍一フ一
十	一丨
驾	力口马
只	口八
眙	目厶口
挽	扌丨フ一ノフ
全	人王
砀	石フノノ
栀	木ノノ一フフ
虑	虍心
氚	气川
顿	屯一ノ冂人
则	冂人刂
尺	尸ㄟ
卡	上卜
鸪	十口鸟
猬	犭田月
茬	艹丨土
髭	一丨一二厶ノノノ止匕
弯	亠丨丨ノ丶弓
灵	彐火
合	人一口
舵	舟宀匕
究	宀八九
汉	氵又
砥	石氐
豉	一口丷一十又
铟	钅囗大
块	土夬guài
砺	石厂万
阐	门丷丨フ一一一丨
判	半刂
淘	氵勹缶
命	人一口卩
派	氵ノノノフノㄟ
酌	酉勺
僇	亻习习人ノノノ
检	木人一⺍一
哥	丁口丁口
卤	丨一囗乂
郇	勹日阝
彧	一口一フノノノ丶
弈	亠ノ丨ノ丶廾
薏	艹立日心
疏	フ止亠厶ノ丨フ
树	木又寸
子	フ丨一
校	木亠八乂
贾	西冂人
桩	木广土
云	二厶
庑	广无
桃	木儿冫ノ丶
贮	冂人宀一
昉	日方
洮	氵儿冫ノ丶
瑭	王广フ一一丨口
疟	疒一フ一
斟	其上八フ丶丶十
桁	木彳亍
讥	讠几
盐	土卜皿
价	亻人ノ丨
廷	廴壬
桦	木亻匕十
泾	氵フ丶工
咽	口囗大
墀	土尸氺牛
桐	木冂一口
镏	钅ノフ丶刀田
桓	木一日一
颀	斤一ノ冂人
孥	女又子
训	讠川
敏	ノ一母攵
畏	田一フノㄟ
莞	艹宀二儿
佟	亻夂丶丶
钽	钅日一
蒽	艹囗大心
莘	艹立十
仑	人匕
实	宀丶丶大
滑	氵骨
荼	艹人余下
钭	钅丶丶十
驶	马史
莴	艹口内
泮	氵半
步	止丨ノノ
莫	艹日大
赘	フノ攵冂人
零	雨人丶
鸣	口鸟
绑	纟寿上阝
恭	艹一八
隐	阝彐心
揽	扌丨丨ノ一丶冂见下
珽	王壬廴
设	讠几又
挫	扌人人土
岘	山冂见下
迫	辶白
耄	耂匕毛
阏	门方人丶丶
逝	辶扌斤
捌	扌口力刂
昏	氏日
嘏	十口フ一丨一一フ一又
弁	厶廾
杀	乂朩
袁	土口𧘇
企	人止
叭	口八
揭	扌日勹人フ
班	王丶ノ王
议	讠义
洑	氵亻犬
垲	土山己
捏	扌日土
啐	口亠人人十
队	阝人
苤	艹丕
笥	フ一口
沘	氵比左匕
彷	彳方
架	力口木
埕	土口王
电	丨フ一一フ
签	人一⺍一
搽	扌艹人朩
匿	匚艹口
落	艹氵夂口
邱	丘阝
嗟	口工
耙	耒巴
耗	耒毛
终	纟夂丶丶
需	雨而
蜀	罒勹虫
族	方ノ一矢
最	日耳又
净	冫フ一一丨
圪	土乞
绒	纟戈
搭	扌艹人一口
吭	口亠几
手	ノ一一丨
筮	工人人
祜	礻十口
浑	氵冖车
唐	广フ一一丨口
贺	力口冂人
迓	辶牙
靶	革巴
挤	扌文ノ丨
赑	冂人冂人冂人
汊	氵叉
德	彳十罒一心
娆	女一フノ兀
娅	女亚
芟	艹几又
粥	弓米弓
娃	女土土
鲥	鱼日寸
费	弗冂人
昨	日乍
氘	气ノ丨
功	工力
谐	讠比左匕白
辁	车人王
氐	氏丶
鸾	亠丨丨ノ丶鸟
岵	山十口
茁	艹出
征	彳正
诲	讠ノ一母
鲵	鱼臼儿
馉	饣骨
榉	木⺍一八一一丨
衿	衤人丶フ
衲	衤内
客	宀夂口
涑	氵束
宥	宀月
鸮	口一フ鸟
反	ノノ又
呸	口丕
踮	广丨一口
帮	寿上阝巾
诤	讠フ一一丨
利	禾刂
未	一一丨ノㄟ
牟	厶牛
艟	舟立里
钤	钅人丶フ
恬	忄千口
疽	疒且
施	方ノ一也
巾	丨フ丨
撤	扌亠厶月攵
迁	辶千
翁	八厶习习
屐	尸彳十又
汐	氵夕
订	讠丁
咴	口火
洴	氵丷开
洋	氵羊
蒴	艹丷一フ丨ノ月
觉	⺍冖冂见下
秉	ノ一フ一一丨ノㄟ
洎	氵自
讹	讠亻匕
月	冂一一
武	一弋止
淑	氵上小又
秭	禾ノフ丨ノ
跑	勹巳
羑	久
疭	疒人人
冈	冂乂
差	工
穸	宀八夕
炷	火主
烁	火乐
吸	口及
哽	口更
沾	氵丨一口
挟	扌夹
尥	尢勺
炳	火丙
娄	米女
闽	门虫
癀	疒艹一由八
丁	一丨
币	ノ巾
精	米月
援	扌ノ⺍一又
铽	钅弋心
陀	阝宀匕
扈	户口巴
版	片ノノ又
峦	亠丨丨ノ丶山
哭	口口犬
沮	氵且
粮	米良
予	フ丨
铭	钅夕口
蜿	虫宀夕フフ
羸	亡口月羊凡
沦	氵人匕
沆	氵亠几
瓴	人丶瓦
食	人良
郤	八人口阝
娉	女由一フ
叙	人余下又
待	彳土寸
琤	王フ一一丨
苟	艹勹口
募	艹日大力
拟	扌フ丶人
孟	子皿
垡	亻戈土
繁	ノ一母攵幺小
昀	日勹冫
嘀	口亠丷冂十口
才	一丨ノ
毵	厶大ノノノ毛
琴	王王人丶フ
阀	门亻戈
吴	口天
屯	一フ丨フ
戈	一フノ丶
诵	讠用
牯	牛十口
甭	不用
毡	毛丨一口
锭	钅宀一丨一人
钡	钅冂人
钚	钅不
迸	辶丷开
忸	忄丑
替	夫夫日
哟	口纟勺
俸	亻寿上ㄟ一一丨
刈	乂刂
咤	口宀ノ七
原	厂白小
丢	ノ土厶
眄	目丏
老	耂匕
镤	钅业ㄟ
蕤	艹豕生
钐	钅ノノノ
呲	口止匕
金	人干丷一
坭	土尸匕
星	日生
哄	口艹一八
钗	钅叉
雀	少丨亠
咭	156
眈	目丶フノフ
兵	丘八
沉	氵冖几
亢	亠几
褶	衤习习白
轷	车乎
形	开ノノノ
牵	大冖牛
砭	石乏
砚	石冂见下
缮	纟羊丷一口
讵	讠巨
柿	木亠巾
铈	钅亠巾
栅	木册
粉	米八刀
貉	豸夂口
肤	月夫
卟	口卜
斤	ノノ一丨
疤	疒巴
荟	艹人二厶
荫	艹阝月
咀	口且
荤	艹冖车
荡	艹氵フノノ
仁	亻二
绁	纟世
滁	氵阝人余下
著	艹耂日
蚀	饣虫
垠	土艮
筐	匚王
泉	白水
况	冫口儿
咄	口出
于	一一丨
城	土成
外	夕卜
型	开刂土
邴	丙阝
绮	纟大丁口
远	辶二儿
饭	饣ノノ又
抬	扌厶口
飞	フノ丶
针	钅十
蒈	艹比左匕白
璈	王フノ攵
窘	宀八尹口
津	氵聿
吟	口人丶フ
扬	扌フノノ
妯	女由
鲐	鱼厶口
铤	钅壬廴
败	冂人攵
沐	氵木
北	丨一一匕
茗	艹夕口
猗	犭大丁口
佘	人二小
犬	大丶
饥	饣几
芬	艹八刀
屉	尸世
抑	扌ノフ卩
镀	钅广廿又
效	亠八乂攵
畀	田一ノ丨
乜	フフ
诘	讠士口
洁	氵士口
綮	户攵幺小
宙	宀由
闭	门才
拗	扌幺力
畈	田ノノ又
蕈	艹西日十
镈	钅甫寸
旭	九日
泥	氵尸匕
怛	忄日一
吓	口下
峥	山フ一一丨
鳐	鱼ノ⺍缶
妄	亡女
菟	艹丨フ一ノフ丶
昽	日龙
阽	阝丨一口
泐	氵阝力
狗	犭勹口
苗	艹田
汈	氵刁
叽	口几
吹	口人
饶	饣一フノ兀
购	冂人勹厶
址	土止
浉	氵丨ノ一巾
奶	女乃
赁	亻壬冂人
水	丨フノㄟ
流	氵亠厶ノ丨フ
沥	氵厂力
岐	山十又
絮	女口幺小
衣	亠𧘇
呗	口冂人
赉	来冂人
存	丨子
昭	日刀口
锈	钅禾乃
